REGIONAL,ANO,MES,QUANTIDADE DE CHAMADOS,SLA DENTRO DO PRAZO,SLA FORA DO PRAZO,PORCENTAGEM SLA DENTRO DO PRAZO,PORCENTAGEM SLA FORA DO PRAZO
Barra da Tijuca,2015,1,3,3,0,100.0,0.0
Barra da Tijuca,2015,2,29,29,0,100.0,0.0
Barra da Tijuca,2015,3,5,5,0,100.0,0.0
Barra da Tijuca,2015,4,117,117,0,100.0,0.0
Barra da Tijuca,2015,5,1858,1858,0,100.0,0.0
Barra da Tijuca,2015,6,2682,2682,0,100.0,0.0
Barra da Tijuca,2015,7,3057,3057,0,100.0,0.0
Barra da Tijuca,2015,8,2729,2729,0,100.0,0.0
Barra da Tijuca,2015,9,3216,3216,0,100.0,0.0
Barra da Tijuca,2015,10,2895,2895,0,100.0,0.0
Barra da Tijuca,2015,11,2621,2621,0,100.0,0.0
Barra da Tijuca,2015,12,3223,3214,9,99.72,0.28
Barra da Tijuca,2016,1,4189,3898,291,93.05,6.95
Barra da Tijuca,2016,2,3305,3257,48,98.55,1.45
Barra da Tijuca,2016,3,4636,3980,656,85.85,14.15
Barra da Tijuca,2016,4,4205,2641,1564,62.81,37.19
Barra da Tijuca,2016,5,3714,2852,862,76.79,23.21
Barra da Tijuca,2016,6,3870,2950,920,76.23,23.77
Barra da Tijuca,2016,7,4187,3230,957,77.14,22.86
Barra da Tijuca,2016,8,5326,4573,753,85.86,14.14
Barra da Tijuca,2016,9,4940,4265,675,86.34,13.66
Barra da Tijuca,2016,10,6513,3442,3071,52.85,47.15
Barra da Tijuca,2016,11,3966,2498,1468,62.99,37.01
Barra da Tijuca,2016,12,3292,2239,1053,68.01,31.99
Barra da Tijuca,2017,1,6439,3214,3225,49.91,50.09
Barra da Tijuca,2017,2,3551,2819,732,79.39,20.61
Barra da Tijuca,2017,3,6495,3622,2873,55.77,44.23
Barra da Tijuca,2017,4,4579,3149,1430,68.77,31.23
Barra da Tijuca,2017,5,5115,3935,1180,76.93,23.07
Barra da Tijuca,2017,6,6158,4856,1302,78.86,21.14
Barra da Tijuca,2017,7,6002,5005,997,83.39,16.61
Barra da Tijuca,2017,8,6944,5388,1556,77.59,22.41
Barra da Tijuca,2017,9,5542,4427,1115,79.88,20.12
Barra da Tijuca,2017,10,6302,4984,1318,79.09,20.91
Barra da Tijuca,2017,11,4631,4288,343,92.59,7.41
Barra da Tijuca,2017,12,4159,3718,441,89.4,10.6
Barra da Tijuca,2018,1,5080,4219,861,83.05,16.95
Barra da Tijuca,2018,2,5360,4029,1331,75.17,24.83
Barra da Tijuca,2018,3,4739,4141,598,87.38,12.62
Barra da Tijuca,2018,4,3754,3112,642,82.9,17.1
Barra da Tijuca,2018,5,4301,3136,1165,72.91,27.09
Barra da Tijuca,2018,6,3368,2898,470,86.05,13.95
Barra da Tijuca,2018,7,3724,3282,442,88.13,11.87
Barra da Tijuca,2018,8,3487,3099,388,88.87,11.13
Barra da Tijuca,2018,9,3324,2886,438,86.82,13.18
Barra da Tijuca,2018,10,4333,3512,821,81.05,18.95
Barra da Tijuca,2018,11,4166,3643,523,87.45,12.55
Barra da Tijuca,2018,12,3576,2997,579,83.81,16.19
Barra da Tijuca,2019,1,3913,3403,510,86.97,13.03
Barra da Tijuca,2019,2,3773,3361,412,89.08,10.92
Barra da Tijuca,2019,3,3516,2909,607,82.74,17.26
Barra da Tijuca,2019,4,3517,3015,502,85.73,14.27
Barra da Tijuca,2019,5,3175,2670,505,84.09,15.91
Barra da Tijuca,2019,6,2886,2364,522,81.91,18.09
Barra da Tijuca,2019,7,3264,2687,577,82.32,17.68
Barra da Tijuca,2019,8,2899,2521,378,86.96,13.04
Barra da Tijuca,2019,9,2730,2450,280,89.74,10.26
Barra da Tijuca,2019,10,2809,2472,337,88.0,12.0
Barra da Tijuca,2019,11,0,0,0,0.0,0.0
Barra da Tijuca,2019,12,0,0,0,0.0,0.0
Bauru,2015,1,948,939,9,99.05,0.95
Bauru,2015,2,312,311,1,99.68,0.32
Bauru,2015,3,179,177,2,98.88,1.12
Bauru,2015,4,1409,1395,14,99.01,0.99
Bauru,2015,5,2280,1939,341,85.04,14.96
Bauru,2015,6,3819,2637,1182,69.05,30.95
Bauru,2015,7,3477,3157,320,90.8,9.2
Bauru,2015,8,3057,2890,167,94.54,5.46
Bauru,2015,9,3884,2779,1105,71.55,28.45
Bauru,2015,10,428,282,146,65.89,34.11
Bauru,2015,11,3687,3170,517,85.98,14.02
Bauru,2015,12,3890,3349,541,86.09,13.91
Bauru,2016,1,3643,2919,724,80.13,19.87
Bauru,2016,2,3265,2706,559,82.88,17.12
Bauru,2016,3,6122,4452,1670,72.72,27.28
Bauru,2016,4,4956,3255,1701,65.68,34.32
Bauru,2016,5,4486,3465,1021,77.24,22.76
Bauru,2016,6,4341,3612,729,83.21,16.79
Bauru,2016,7,6585,4062,2523,61.69,38.31
Bauru,2016,8,5952,4204,1748,70.63,29.37
Bauru,2016,9,5529,3802,1727,68.76,31.24
Bauru,2016,10,5214,3867,1347,74.17,25.83
Bauru,2016,11,4155,2731,1424,65.73,34.27
Bauru,2016,12,3071,2540,531,82.71,17.29
Bauru,2017,1,6247,3436,2811,55.0,45.0
Bauru,2017,2,3143,2627,516,83.58,16.42
Bauru,2017,3,6336,3731,2605,58.89,41.11
Bauru,2017,4,3858,2815,1043,72.97,27.03
Bauru,2017,5,4517,3772,745,83.51,16.49
Bauru,2017,6,6052,4583,1469,75.73,24.27
Bauru,2017,7,5671,4875,796,85.96,14.04
Bauru,2017,8,6014,5057,957,84.09,15.91
Bauru,2017,9,5293,4288,1005,81.01,18.99
Bauru,2017,10,5410,4630,780,85.58,14.42
Bauru,2017,11,4431,3940,491,88.92,11.08
Bauru,2017,12,4701,3908,793,83.13,16.87
Bauru,2018,1,4808,4131,677,85.92,14.08
Bauru,2018,2,3615,3155,460,87.28,12.72
Bauru,2018,3,4234,3805,429,89.87,10.13
Bauru,2018,4,3839,3184,655,82.94,17.06
Bauru,2018,5,3318,2928,390,88.25,11.75
Bauru,2018,6,3109,2833,276,91.12,8.88
Bauru,2018,7,3501,3292,209,94.03,5.97
Bauru,2018,8,3188,2992,196,93.85,6.15
Bauru,2018,9,3050,2848,202,93.38,6.62
Bauru,2018,10,3772,3492,280,92.58,7.42
Bauru,2018,11,3889,3589,300,92.29,7.71
Bauru,2018,12,3021,2657,364,87.95,12.05
Bauru,2019,1,3323,3019,304,90.85,9.15
Bauru,2019,2,3096,2775,321,89.63,10.37
Bauru,2019,3,2955,2567,388,86.87,13.13
Bauru,2019,4,2762,2586,176,93.63,6.37
Bauru,2019,5,2365,2220,145,93.87,6.13
Bauru,2019,6,2260,2072,188,91.68,8.32
Bauru,2019,7,2853,2441,412,85.56,14.44
Bauru,2019,8,2509,2277,232,90.75,9.25
Bauru,2019,9,2799,2586,213,92.39,7.61
Bauru,2019,10,5593,4851,742,86.73,13.27
Bauru,2019,11,1031,973,58,94.37,5.63
Bauru,2019,12,0,0,0,0.0,0.0
Belem,2015,1,87,87,0,100.0,0.0
Belem,2015,2,8,8,0,100.0,0.0
Belem,2015,3,24,24,0,100.0,0.0
Belem,2015,4,213,213,0,100.0,0.0
Belem,2015,5,2584,2584,0,100.0,0.0
Belem,2015,6,3543,3543,0,100.0,0.0
Belem,2015,7,3833,3833,0,100.0,0.0
Belem,2015,8,3764,3764,0,100.0,0.0
Belem,2015,9,3595,3594,1,99.97,0.03
Belem,2015,10,402,401,1,99.75,0.25
Belem,2015,11,4524,4524,0,100.0,0.0
Belem,2015,12,4631,4617,14,99.7,0.3
Belem,2016,1,4230,4108,122,97.12,2.88
Belem,2016,2,4077,3831,246,93.97,6.03
Belem,2016,3,5846,5373,473,91.91,8.09
Belem,2016,4,5672,4236,1436,74.68,25.32
Belem,2016,5,6062,4723,1339,77.91,22.09
Belem,2016,6,5739,4580,1159,79.8,20.2
Belem,2016,7,6160,4841,1319,78.59,21.41
Belem,2016,8,7456,5914,1542,79.32,20.68
Belem,2016,9,7053,5688,1365,80.65,19.35
Belem,2016,10,7843,4284,3559,54.62,45.38
Belem,2016,11,5311,3454,1857,65.03,34.97
Belem,2016,12,4638,3581,1057,77.21,22.79
Belem,2017,1,8417,4876,3541,57.93,42.07
Belem,2017,2,4546,3721,825,81.85,18.15
Belem,2017,3,8478,6127,2351,72.27,27.73
Belem,2017,4,5840,4095,1745,70.12,29.88
Belem,2017,5,6680,4870,1810,72.9,27.1
Belem,2017,6,7319,5405,1914,73.85,26.15
Belem,2017,7,6655,5440,1215,81.74,18.26
Belem,2017,8,8802,6129,2673,69.63,30.37
Belem,2017,9,5978,5098,880,85.28,14.72
Belem,2017,10,6578,5439,1139,82.68,17.32
Belem,2017,11,5822,5178,644,88.94,11.06
Belem,2017,12,5204,4547,657,87.38,12.62
Belem,2018,1,6312,5217,1095,82.65,17.35
Belem,2018,2,7256,5603,1653,77.22,22.78
Belem,2018,3,6314,4888,1426,77.42,22.58
Belem,2018,4,5057,4220,837,83.45,16.55
Belem,2018,5,5988,5374,614,89.75,10.25
Belem,2018,6,4266,3649,617,85.54,14.46
Belem,2018,7,4548,3932,616,86.46,13.54
Belem,2018,8,4451,4085,366,91.78,8.22
Belem,2018,9,3845,3355,490,87.26,12.74
Belem,2018,10,4938,4185,753,84.75,15.25
Belem,2018,11,4455,3778,677,84.8,15.2
Belem,2018,12,4648,3867,781,83.2,16.8
Belem,2019,1,4734,4237,497,89.5,10.5
Belem,2019,2,3996,3598,398,90.04,9.96
Belem,2019,3,4027,3465,562,86.04,13.96
Belem,2019,4,4130,3671,459,88.89,11.11
Belem,2019,5,3893,3395,498,87.21,12.79
Belem,2019,6,3291,2880,411,87.51,12.49
Belem,2019,7,3983,3273,710,82.17,17.83
Belem,2019,8,3697,3390,307,91.7,8.3
Belem,2019,9,4173,3423,750,82.03,17.97
Belem,2019,10,8229,7000,1229,85.07,14.93
Belem,2019,11,1456,1321,135,90.73,9.27
Belem,2019,12,1,1,0,100.0,0.0
Belo Horizonte,2015,1,9,9,0,100.0,0.0
Belo Horizonte,2015,2,5,5,0,100.0,0.0
Belo Horizonte,2015,3,4,4,0,100.0,0.0
Belo Horizonte,2015,4,170,170,0,100.0,0.0
Belo Horizonte,2015,5,2552,2552,0,100.0,0.0
Belo Horizonte,2015,6,3695,3695,0,100.0,0.0
Belo Horizonte,2015,7,4126,4126,0,100.0,0.0
Belo Horizonte,2015,8,3669,3669,0,100.0,0.0
Belo Horizonte,2015,9,3771,3771,0,100.0,0.0
Belo Horizonte,2015,10,337,337,0,100.0,0.0
Belo Horizonte,2015,11,4032,4032,0,100.0,0.0
Belo Horizonte,2015,12,3894,3893,1,99.97,0.03
Belo Horizonte,2016,1,4539,4172,367,91.91,8.09
Belo Horizonte,2016,2,3819,3813,6,99.84,0.16
Belo Horizonte,2016,3,4917,4792,125,97.46,2.54
Belo Horizonte,2016,4,4778,3592,1186,75.18,24.82
Belo Horizonte,2016,5,4954,3900,1054,78.72,21.28
Belo Horizonte,2016,6,4917,3911,1006,79.54,20.46
Belo Horizonte,2016,7,6035,4810,1225,79.7,20.3
Belo Horizonte,2016,8,7175,6017,1158,83.86,16.14
Belo Horizonte,2016,9,6403,5433,970,84.85,15.15
Belo Horizonte,2016,10,9352,5799,3553,62.01,37.99
Belo Horizonte,2016,11,4705,3372,1333,71.67,28.33
Belo Horizonte,2016,12,5681,4296,1385,75.62,24.38
Belo Horizonte,2017,1,8193,5705,2488,69.63,30.37
Belo Horizonte,2017,2,4163,3199,964,76.84,23.16
Belo Horizonte,2017,3,8252,6681,1571,80.96,19.04
Belo Horizonte,2017,4,6092,4971,1121,81.6,18.4
Belo Horizonte,2017,5,6819,6178,641,90.6,9.4
Belo Horizonte,2017,6,7891,7379,512,93.51,6.49
Belo Horizonte,2017,7,8137,7176,961,88.19,11.81
Belo Horizonte,2017,8,9213,8122,1091,88.16,11.84
Belo Horizonte,2017,9,7296,6061,1235,83.07,16.93
Belo Horizonte,2017,10,6649,6036,613,90.78,9.22
Belo Horizonte,2017,11,5895,5461,434,92.64,7.36
Belo Horizonte,2017,12,5735,5017,718,87.48,12.52
Belo Horizonte,2018,1,6365,5202,1163,81.73,18.27
Belo Horizonte,2018,2,5715,3860,1855,67.54,32.46
Belo Horizonte,2018,3,5613,4695,918,83.65,16.35
Belo Horizonte,2018,4,4612,3955,657,85.75,14.25
Belo Horizonte,2018,5,4091,3674,417,89.81,10.19
Belo Horizonte,2018,6,4287,3673,614,85.68,14.32
Belo Horizonte,2018,7,4995,4289,706,85.87,14.13
Belo Horizonte,2018,8,4378,3889,489,88.83,11.17
Belo Horizonte,2018,9,4165,3731,434,89.58,10.42
Belo Horizonte,2018,10,5170,4537,633,87.76,12.24
Belo Horizonte,2018,11,5036,4675,361,92.83,7.17
Belo Horizonte,2018,12,4168,3629,539,87.07,12.93
Belo Horizonte,2019,1,4266,3866,400,90.62,9.38
Belo Horizonte,2019,2,4141,3804,337,91.86,8.14
Belo Horizonte,2019,3,3792,3296,496,86.92,13.08
Belo Horizonte,2019,4,3817,3515,302,92.09,7.91
Belo Horizonte,2019,5,3650,3250,400,89.04,10.96
Belo Horizonte,2019,6,3187,2936,251,92.12,7.88
Belo Horizonte,2019,7,3887,3441,446,88.53,11.47
Belo Horizonte,2019,8,3076,2899,177,94.25,5.75
Belo Horizonte,2019,9,3367,3126,241,92.84,7.16
Belo Horizonte,2019,10,7510,6730,780,89.61,10.39
Belo Horizonte,2019,11,1414,1352,62,95.62,4.38
Belo Horizonte,2019,12,0,0,0,0.0,0.0
Brasilia,2015,1,23,23,0,100.0,0.0
Brasilia,2015,2,2,2,0,100.0,0.0
Brasilia,2015,3,7,7,0,100.0,0.0
Brasilia,2015,4,201,201,0,100.0,0.0
Brasilia,2015,5,2970,2970,0,100.0,0.0
Brasilia,2015,6,4099,4099,0,100.0,0.0
Brasilia,2015,7,4390,4390,0,100.0,0.0
Brasilia,2015,8,4170,4168,2,99.95,0.05
Brasilia,2015,9,4180,4179,1,99.98,0.02
Brasilia,2015,10,309,309,0,100.0,0.0
Brasilia,2015,11,4615,4615,0,100.0,0.0
Brasilia,2015,12,4568,4568,0,100.0,0.0
Brasilia,2016,1,5189,4855,334,93.56,6.44
Brasilia,2016,2,4499,4493,6,99.87,0.13
Brasilia,2016,3,5819,5644,175,96.99,3.01
Brasilia,2016,4,6830,5871,959,85.96,14.04
Brasilia,2016,5,6192,5658,534,91.38,8.62
Brasilia,2016,6,6165,5123,1042,83.1,16.9
Brasilia,2016,7,6883,5745,1138,83.47,16.53
Brasilia,2016,8,6950,6363,587,91.55,8.45
Brasilia,2016,9,7393,6692,701,90.52,9.48
Brasilia,2016,10,8544,5880,2664,68.82,31.18
Brasilia,2016,11,5808,3943,1865,67.89,32.11
Brasilia,2016,12,4545,3840,705,84.49,15.51
Brasilia,2017,1,8290,5110,3180,61.64,38.36
Brasilia,2017,2,4483,4054,429,90.43,9.57
Brasilia,2017,3,8845,5940,2905,67.16,32.84
Brasilia,2017,4,6150,4292,1858,69.79,30.21
Brasilia,2017,5,6993,5413,1580,77.41,22.59
Brasilia,2017,6,5990,5443,547,90.87,9.13
Brasilia,2017,7,6513,5526,987,84.85,15.15
Brasilia,2017,8,8256,6955,1301,84.24,15.76
Brasilia,2017,9,7351,6024,1327,81.95,18.05
Brasilia,2017,10,7512,6338,1174,84.37,15.63
Brasilia,2017,11,6602,6092,510,92.28,7.72
Brasilia,2017,12,5820,5183,637,89.05,10.95
Brasilia,2018,1,7021,5897,1124,83.99,16.01
Brasilia,2018,2,5405,4452,953,82.37,17.63
Brasilia,2018,3,5889,5085,804,86.35,13.65
Brasilia,2018,4,4702,4080,622,86.77,13.23
Brasilia,2018,5,4571,3911,660,85.56,14.44
Brasilia,2018,6,4693,3945,748,84.06,15.94
Brasilia,2018,7,5227,4447,780,85.08,14.92
Brasilia,2018,8,5119,4689,430,91.6,8.4
Brasilia,2018,9,4529,4002,527,88.36,11.64
Brasilia,2018,10,5675,4952,723,87.26,12.74
Brasilia,2018,11,5154,4573,581,88.73,11.27
Brasilia,2018,12,4475,3839,636,85.79,14.21
Brasilia,2019,1,5030,4589,441,91.23,8.77
Brasilia,2019,2,4112,3685,427,89.62,10.38
Brasilia,2019,3,4076,3465,611,85.01,14.99
Brasilia,2019,4,4488,3930,558,87.57,12.43
Brasilia,2019,5,3919,3502,417,89.36,10.64
Brasilia,2019,6,3378,2950,428,87.33,12.67
Brasilia,2019,7,3998,3459,539,86.52,13.48
Brasilia,2019,8,3449,3169,280,91.88,8.12
Brasilia,2019,9,3592,3308,284,92.09,7.91
Brasilia,2019,10,8199,7432,767,90.65,9.35
Brasilia,2019,11,1564,1476,88,94.37,5.63
Brasilia,2019,12,0,0,0,0.0,0.0
Campinas,2015,1,1146,1120,26,97.73,2.27
Campinas,2015,2,351,350,1,99.72,0.28
Campinas,2015,3,299,297,2,99.33,0.67
Campinas,2015,4,1520,1492,28,98.16,1.84
Campinas,2015,5,3234,2869,365,88.71,11.29
Campinas,2015,6,4959,3676,1283,74.13,25.87
Campinas,2015,7,5219,4880,339,93.5,6.5
Campinas,2015,8,4842,4516,326,93.27,6.73
Campinas,2015,9,5478,4303,1175,78.55,21.45
Campinas,2015,10,448,268,180,59.82,40.18
Campinas,2015,11,4394,3922,472,89.26,10.74
Campinas,2015,12,5112,4039,1073,79.01,20.99
Campinas,2016,1,4563,4224,339,92.57,7.43
Campinas,2016,2,4094,3736,358,91.26,8.74
Campinas,2016,3,6311,5087,1224,80.61,19.39
Campinas,2016,4,6254,5354,900,85.61,14.39
Campinas,2016,5,5591,4969,622,88.87,11.13
Campinas,2016,6,5795,5147,648,88.82,11.18
Campinas,2016,7,7241,5006,2235,69.13,30.87
Campinas,2016,8,8697,6260,2437,71.98,28.02
Campinas,2016,9,8422,6484,1938,76.99,23.01
Campinas,2016,10,6714,4952,1762,73.76,26.24
Campinas,2016,11,4404,3557,847,80.77,19.23
Campinas,2016,12,4058,3457,601,85.19,14.81
Campinas,2017,1,7424,4647,2777,62.59,37.41
Campinas,2017,2,4238,3659,579,86.34,13.66
Campinas,2017,3,7391,4832,2559,65.38,34.62
Campinas,2017,4,5727,4156,1571,72.57,27.43
Campinas,2017,5,6478,5130,1348,79.19,20.81
Campinas,2017,6,5564,5103,461,91.71,8.29
Campinas,2017,7,7187,5362,1825,74.61,25.39
Campinas,2017,8,6302,5553,749,88.11,11.89
Campinas,2017,9,6693,5137,1556,76.75,23.25
Campinas,2017,10,6029,5127,902,85.04,14.96
Campinas,2017,11,5356,4901,455,91.5,8.5
Campinas,2017,12,5235,4395,840,83.95,16.05
Campinas,2018,1,5669,4801,868,84.69,15.31
Campinas,2018,2,4112,3597,515,87.48,12.52
Campinas,2018,3,4508,3915,593,86.85,13.15
Campinas,2018,4,4266,3624,642,84.95,15.05
Campinas,2018,5,3649,3272,377,89.67,10.33
Campinas,2018,6,3869,3520,349,90.98,9.02
Campinas,2018,7,4811,4289,522,89.15,10.85
Campinas,2018,8,5069,4600,469,90.75,9.25
Campinas,2018,9,4389,4003,386,91.21,8.79
Campinas,2018,10,5498,4944,554,89.92,10.08
Campinas,2018,11,4997,4524,473,90.53,9.47
Campinas,2018,12,4214,3727,487,88.44,11.56
Campinas,2019,1,5154,4632,522,89.87,10.13
Campinas,2019,2,4555,4171,384,91.57,8.43
Campinas,2019,3,4189,3746,443,89.42,10.58
Campinas,2019,4,4195,3907,288,93.13,6.87
Campinas,2019,5,3895,3639,256,93.43,6.57
Campinas,2019,6,3366,3176,190,94.36,5.64
Campinas,2019,7,4037,3614,423,89.52,10.48
Campinas,2019,8,3803,3533,270,92.9,7.1
Campinas,2019,9,3765,3546,219,94.18,5.82
Campinas,2019,10,7482,6972,510,93.18,6.82
Campinas,2019,11,1488,1441,47,96.84,3.16
Campinas,2019,12,0,0,0,0.0,0.0
Campo Limpo,2015,1,95,95,0,100.0,0.0
Campo Limpo,2015,2,142,142,0,100.0,0.0
Campo Limpo,2015,3,293,292,1,99.66,0.34
Campo Limpo,2015,4,1328,1328,0,100.0,0.0
Campo Limpo,2015,5,2096,1980,116,94.47,5.53
Campo Limpo,2015,6,3621,3328,293,91.91,8.09
Campo Limpo,2015,7,3192,3092,100,96.87,3.13
Campo Limpo,2015,8,3086,3043,43,98.61,1.39
Campo Limpo,2015,9,3140,2636,504,83.95,16.05
Campo Limpo,2015,10,391,280,111,71.61,28.39
Campo Limpo,2015,11,3160,2920,240,92.41,7.59
Campo Limpo,2015,12,3408,3155,253,92.58,7.42
Campo Limpo,2016,1,2906,2803,103,96.46,3.54
Campo Limpo,2016,2,2871,2564,307,89.31,10.69
Campo Limpo,2016,3,4370,3428,942,78.44,21.56
Campo Limpo,2016,4,4171,2667,1504,63.94,36.06
Campo Limpo,2016,5,3625,3006,619,82.92,17.08
Campo Limpo,2016,6,3778,3074,704,81.37,18.63
Campo Limpo,2016,7,4916,3225,1691,65.6,34.4
Campo Limpo,2016,8,5784,4464,1320,77.18,22.82
Campo Limpo,2016,9,5825,4423,1402,75.93,24.07
Campo Limpo,2016,10,4705,3096,1609,65.8,34.2
Campo Limpo,2016,11,3211,2427,784,75.58,24.42
Campo Limpo,2016,12,2801,2056,745,73.4,26.6
Campo Limpo,2017,1,3865,2702,1163,69.91,30.09
Campo Limpo,2017,2,2832,2173,659,76.73,23.27
Campo Limpo,2017,3,3857,3137,720,81.33,18.67
Campo Limpo,2017,4,3435,2644,791,76.97,23.03
Campo Limpo,2017,5,3887,3302,585,84.95,15.05
Campo Limpo,2017,6,5047,4610,437,91.34,8.66
Campo Limpo,2017,7,6097,4748,1349,77.87,22.13
Campo Limpo,2017,8,5864,5113,751,87.19,12.81
Campo Limpo,2017,9,5281,4268,1013,80.82,19.18
Campo Limpo,2017,10,5026,4374,652,87.03,12.97
Campo Limpo,2017,11,4394,4092,302,93.13,6.87
Campo Limpo,2017,12,5139,4524,615,88.03,11.97
Campo Limpo,2018,1,5687,4676,1011,82.22,17.78
Campo Limpo,2018,2,4867,4362,505,89.62,10.38
Campo Limpo,2018,3,5735,4979,756,86.82,13.18
Campo Limpo,2018,4,4818,4094,724,84.97,15.03
Campo Limpo,2018,5,4912,4444,468,90.47,9.53
Campo Limpo,2018,6,4446,4117,329,92.6,7.4
Campo Limpo,2018,7,6023,4779,1244,79.35,20.65
Campo Limpo,2018,8,6454,4794,1660,74.28,25.72
Campo Limpo,2018,9,5698,4470,1228,78.45,21.55
Campo Limpo,2018,10,4451,3742,709,84.07,15.93
Campo Limpo,2018,11,4125,3641,484,88.27,11.73
Campo Limpo,2018,12,3139,2673,466,85.15,14.85
Campo Limpo,2019,1,3427,3132,295,91.39,8.61
Campo Limpo,2019,2,3454,3209,245,92.91,7.09
Campo Limpo,2019,3,3219,2657,562,82.54,17.46
Campo Limpo,2019,4,2964,2757,207,93.02,6.98
Campo Limpo,2019,5,2737,2502,235,91.41,8.59
Campo Limpo,2019,6,2444,2263,181,92.59,7.41
Campo Limpo,2019,7,2783,2344,439,84.23,15.77
Campo Limpo,2019,8,2450,2300,150,93.88,6.12
Campo Limpo,2019,9,2646,2449,197,92.55,7.45
Campo Limpo,2019,10,5578,5002,576,89.67,10.33
Campo Limpo,2019,11,1025,947,78,92.39,7.61
Campo Limpo,2019,12,0,0,0,0.0,0.0
Carioca - Bradesco Seguros,2015,1,0,0,0,0.0,0.0
Carioca - Bradesco Seguros,2015,2,0,0,0,0.0,0.0
Carioca - Bradesco Seguros,2015,3,4,4,0,100.0,0.0
Carioca - Bradesco Seguros,2015,4,16,16,0,100.0,0.0
Carioca - Bradesco Seguros,2015,5,2476,2476,0,100.0,0.0
Carioca - Bradesco Seguros,2015,6,3734,3734,0,100.0,0.0
Carioca - Bradesco Seguros,2015,7,3831,3831,0,100.0,0.0
Carioca - Bradesco Seguros,2015,8,3599,3599,0,100.0,0.0
Carioca - Bradesco Seguros,2015,9,3205,3205,0,100.0,0.0
Carioca - Bradesco Seguros,2015,10,84,83,1,98.81,1.19
Carioca - Bradesco Seguros,2015,11,3753,3750,3,99.92,0.08
Carioca - Bradesco Seguros,2015,12,4303,4297,6,99.86,0.14
Carioca - Bradesco Seguros,2016,1,4575,4572,3,99.93,0.07
Carioca - Bradesco Seguros,2016,2,3769,3761,8,99.79,0.21
Carioca - Bradesco Seguros,2016,3,4251,4127,124,97.08,2.92
Carioca - Bradesco Seguros,2016,4,2757,2412,345,87.49,12.51
Carioca - Bradesco Seguros,2016,5,2635,2559,76,97.12,2.88
Carioca - Bradesco Seguros,2016,6,2771,2689,82,97.04,2.96
Carioca - Bradesco Seguros,2016,7,2463,2405,58,97.65,2.35
Carioca - Bradesco Seguros,2016,8,3076,2759,317,89.69,10.31
Carioca - Bradesco Seguros,2016,9,3164,2930,234,92.6,7.4
Carioca - Bradesco Seguros,2016,10,2715,2498,217,92.01,7.99
Carioca - Bradesco Seguros,2016,11,3192,2564,628,80.33,19.67
Carioca - Bradesco Seguros,2016,12,2948,2832,116,96.07,3.93
Carioca - Bradesco Seguros,2017,1,3162,2944,218,93.11,6.89
Carioca - Bradesco Seguros,2017,2,2570,2298,272,89.42,10.58
Carioca - Bradesco Seguros,2017,3,3256,3086,170,94.78,5.22
Carioca - Bradesco Seguros,2017,4,2747,2025,722,73.72,26.28
Carioca - Bradesco Seguros,2017,5,748,607,141,81.15,18.85
Carioca - Bradesco Seguros,2017,6,428,257,171,60.05,39.95
Carioca - Bradesco Seguros,2017,7,234,172,62,73.5,26.5
Carioca - Bradesco Seguros,2017,8,109,64,45,58.72,41.28
Carioca - Bradesco Seguros,2017,9,33,27,6,81.82,18.18
Carioca - Bradesco Seguros,2017,10,69,56,13,81.16,18.84
Carioca - Bradesco Seguros,2017,11,62,56,6,90.32,9.68
Carioca - Bradesco Seguros,2017,12,58,41,17,70.69,29.31
Carioca - Bradesco Seguros,2018,1,24,19,5,79.17,20.83
Carioca - Bradesco Seguros,2018,2,18,17,1,94.44,5.56
Carioca - Bradesco Seguros,2018,3,18,5,13,27.78,72.22
Carioca - Bradesco Seguros,2018,4,8,3,5,37.5,62.5
Carioca - Bradesco Seguros,2018,5,16,11,5,68.75,31.25
Carioca - Bradesco Seguros,2018,6,7,4,3,57.14,42.86
Carioca - Bradesco Seguros,2018,7,5,3,2,60.0,40.0
Carioca - Bradesco Seguros,2018,8,6,6,0,100.0,0.0
Carioca - Bradesco Seguros,2018,9,14,10,4,71.43,28.57
Carioca - Bradesco Seguros,2018,10,16,14,2,87.5,12.5
Carioca - Bradesco Seguros,2018,11,5,5,0,100.0,0.0
Carioca - Bradesco Seguros,2018,12,16,16,0,100.0,0.0
Carioca - Bradesco Seguros,2019,1,4,4,0,100.0,0.0
Carioca - Bradesco Seguros,2019,2,7,7,0,100.0,0.0
Carioca - Bradesco Seguros,2019,3,3,3,0,100.0,0.0
Carioca - Bradesco Seguros,2019,4,4,4,0,100.0,0.0
Carioca - Bradesco Seguros,2019,5,2,2,0,100.0,0.0
Carioca - Bradesco Seguros,2019,6,2,2,0,100.0,0.0
Carioca - Bradesco Seguros,2019,7,10,10,0,100.0,0.0
Carioca - Bradesco Seguros,2019,8,16,16,0,100.0,0.0
Carioca - Bradesco Seguros,2019,9,10,10,0,100.0,0.0
Carioca - Bradesco Seguros,2019,10,22,22,0,100.0,0.0
Carioca - Bradesco Seguros,2019,11,2,2,0,100.0,0.0
Carioca - Bradesco Seguros,2019,12,0,0,0,0.0,0.0
Cidade de Deus,2015,1,84,83,1,98.81,1.19
Cidade de Deus,2015,2,42,42,0,100.0,0.0
Cidade de Deus,2015,3,72,72,0,100.0,0.0
Cidade de Deus,2015,4,416,416,0,100.0,0.0
Cidade de Deus,2015,5,1053,1049,4,99.62,0.38
Cidade de Deus,2015,6,1326,1326,0,100.0,0.0
Cidade de Deus,2015,7,1267,1262,5,99.61,0.39
Cidade de Deus,2015,8,1617,1615,2,99.88,0.12
Cidade de Deus,2015,9,2091,2086,5,99.76,0.24
Cidade de Deus,2015,10,3551,3543,8,99.77,0.23
Cidade de Deus,2015,11,2985,2959,26,99.13,0.87
Cidade de Deus,2015,12,2221,2195,26,98.83,1.17
Cidade de Deus,2016,1,2063,2008,55,97.33,2.67
Cidade de Deus,2016,2,2118,2070,48,97.73,2.27
Cidade de Deus,2016,3,2486,2295,191,92.32,7.68
Cidade de Deus,2016,4,2144,1679,465,78.31,21.69
Cidade de Deus,2016,5,2117,1855,262,87.62,12.38
Cidade de Deus,2016,6,2130,1909,221,89.62,10.38
Cidade de Deus,2016,7,2332,2107,225,90.35,9.65
Cidade de Deus,2016,8,2875,2657,218,92.42,7.58
Cidade de Deus,2016,9,3116,2897,219,92.97,7.03
Cidade de Deus,2016,10,3082,2810,272,91.17,8.83
Cidade de Deus,2016,11,3478,3289,189,94.57,5.43
Cidade de Deus,2016,12,2405,2258,147,93.89,6.11
Cidade de Deus,2017,1,3291,2811,480,85.41,14.59
Cidade de Deus,2017,2,930,749,181,80.54,19.46
Cidade de Deus,2017,3,1145,842,303,73.54,26.46
Cidade de Deus,2017,4,1147,788,359,68.7,31.3
Cidade de Deus,2017,5,4339,3608,731,83.15,16.85
Cidade de Deus,2017,6,4199,3787,412,90.19,9.81
Cidade de Deus,2017,7,4108,3345,763,81.43,18.57
Cidade de Deus,2017,8,4450,4097,353,92.07,7.93
Cidade de Deus,2017,9,3917,3317,600,84.68,15.32
Cidade de Deus,2017,10,3660,3353,307,91.61,8.39
Cidade de Deus,2017,11,1334,1200,134,89.96,10.04
Cidade de Deus,2017,12,2085,1823,262,87.43,12.57
Cidade de Deus,2018,1,1590,1400,190,88.05,11.95
Cidade de Deus,2018,2,1597,1439,158,90.11,9.89
Cidade de Deus,2018,3,1434,1310,124,91.35,8.65
Cidade de Deus,2018,4,1301,1153,148,88.62,11.38
Cidade de Deus,2018,5,1006,904,102,89.86,10.14
Cidade de Deus,2018,6,945,842,103,89.1,10.9
Cidade de Deus,2018,7,1448,1299,149,89.71,10.29
Cidade de Deus,2018,8,1394,1228,166,88.09,11.91
Cidade de Deus,2018,9,1690,1547,143,91.54,8.46
Cidade de Deus,2018,10,2040,1927,113,94.46,5.54
Cidade de Deus,2018,11,1494,1429,65,95.65,4.35
Cidade de Deus,2018,12,1187,1108,79,93.34,6.66
Cidade de Deus,2019,1,1006,954,52,94.83,5.17
Cidade de Deus,2019,2,1263,1161,102,91.92,8.08
Cidade de Deus,2019,3,870,823,47,94.6,5.4
Cidade de Deus,2019,4,1159,1067,92,92.06,7.94
Cidade de Deus,2019,5,1941,1788,153,92.12,7.88
Cidade de Deus,2019,6,2501,2438,63,97.48,2.52
Cidade de Deus,2019,7,3196,3116,80,97.5,2.5
Cidade de Deus,2019,8,2113,2043,70,96.69,3.31
Cidade de Deus,2019,9,2874,2829,45,98.43,1.57
Cidade de Deus,2019,10,2758,2718,40,98.55,1.45
Cidade de Deus,2019,11,0,0,0,0.0,0.0
Cidade de Deus,2019,12,0,0,0,0.0,0.0
Cuiabá,2015,1,34,34,0,100.0,0.0
Cuiabá,2015,2,2,1,1,50.0,50.0
Cuiabá,2015,3,12,12,0,100.0,0.0
Cuiabá,2015,4,190,188,2,98.95,1.05
Cuiabá,2015,5,2125,2125,0,100.0,0.0
Cuiabá,2015,6,2634,2634,0,100.0,0.0
Cuiabá,2015,7,3532,3531,1,99.97,0.03
Cuiabá,2015,8,3009,3008,1,99.97,0.03
Cuiabá,2015,9,3735,3734,1,99.97,0.03
Cuiabá,2015,10,3579,3573,6,99.83,0.17
Cuiabá,2015,11,4046,4044,2,99.95,0.05
Cuiabá,2015,12,3213,3204,9,99.72,0.28
Cuiabá,2016,1,3960,3534,426,89.24,10.76
Cuiabá,2016,2,3356,3329,27,99.2,0.8
Cuiabá,2016,3,4247,4030,217,94.89,5.11
Cuiabá,2016,4,4431,3463,968,78.15,21.85
Cuiabá,2016,5,4577,3847,730,84.05,15.95
Cuiabá,2016,6,4313,3601,712,83.49,16.51
Cuiabá,2016,7,6224,4618,1606,74.2,25.8
Cuiabá,2016,8,4918,4198,720,85.36,14.64
Cuiabá,2016,9,4684,3670,1014,78.35,21.65
Cuiabá,2016,10,7972,6154,1818,77.2,22.8
Cuiabá,2016,11,4618,3694,924,79.99,20.01
Cuiabá,2016,12,3262,2444,818,74.92,25.08
Cuiabá,2017,1,6879,4743,2136,68.95,31.05
Cuiabá,2017,2,3449,2718,731,78.81,21.19
Cuiabá,2017,3,6673,5425,1248,81.3,18.7
Cuiabá,2017,4,4860,3673,1187,75.58,24.42
Cuiabá,2017,5,5241,4337,904,82.75,17.25
Cuiabá,2017,6,6446,5677,769,88.07,11.93
Cuiabá,2017,7,6261,4972,1289,79.41,20.59
Cuiabá,2017,8,7199,6095,1104,84.66,15.34
Cuiabá,2017,9,6004,4495,1509,74.87,25.13
Cuiabá,2017,10,5913,4443,1470,75.14,24.86
Cuiabá,2017,11,5044,4256,788,84.38,15.62
Cuiabá,2017,12,4198,3454,744,82.28,17.72
Cuiabá,2018,1,4879,3950,929,80.96,19.04
Cuiabá,2018,2,4281,3183,1098,74.35,25.65
Cuiabá,2018,3,4571,3817,754,83.5,16.5
Cuiabá,2018,4,3960,3078,882,77.73,22.27
Cuiabá,2018,5,3625,2928,697,80.77,19.23
Cuiabá,2018,6,3216,2566,650,79.79,20.21
Cuiabá,2018,7,3700,2757,943,74.51,25.49
Cuiabá,2018,8,3605,3053,552,84.69,15.31
Cuiabá,2018,9,3850,3143,707,81.64,18.36
Cuiabá,2018,10,4146,3289,857,79.33,20.67
Cuiabá,2018,11,4263,3340,923,78.35,21.65
Cuiabá,2018,12,3114,2402,712,77.14,22.86
Cuiabá,2019,1,3478,2864,614,82.35,17.65
Cuiabá,2019,2,2981,2522,459,84.6,15.4
Cuiabá,2019,3,2905,2308,597,79.45,20.55
Cuiabá,2019,4,3044,2554,490,83.9,16.1
Cuiabá,2019,5,2951,2444,507,82.82,17.18
Cuiabá,2019,6,2445,1976,469,80.82,19.18
Cuiabá,2019,7,3037,2379,658,78.33,21.67
Cuiabá,2019,8,2535,2105,430,83.04,16.96
Cuiabá,2019,9,2438,1952,486,80.07,19.93
Cuiabá,2019,10,2419,1908,511,78.88,21.12
Cuiabá,2019,11,0,0,0,0.0,0.0
Cuiabá,2019,12,0,0,0,0.0,0.0
Curitiba,2015,1,258,243,15,94.19,5.81
Curitiba,2015,2,254,254,0,100.0,0.0
Curitiba,2015,3,126,125,1,99.21,0.79
Curitiba,2015,4,1937,1936,1,99.95,0.05
Curitiba,2015,5,3428,3173,255,92.56,7.44
Curitiba,2015,6,5373,4504,869,83.83,16.17
Curitiba,2015,7,4670,4299,371,92.06,7.94
Curitiba,2015,8,4456,4278,178,96.01,3.99
Curitiba,2015,9,5589,4089,1500,73.16,26.84
Curitiba,2015,10,4559,4428,131,97.13,2.87
Curitiba,2015,11,5088,4575,513,89.92,10.08
Curitiba,2015,12,4138,4018,120,97.1,2.9
Curitiba,2016,1,5380,3750,1630,69.7,30.3
Curitiba,2016,2,4258,3939,319,92.51,7.49
Curitiba,2016,3,7045,5209,1836,73.94,26.06
Curitiba,2016,4,5844,4433,1411,75.86,24.14
Curitiba,2016,5,5951,5027,924,84.47,15.53
Curitiba,2016,6,6882,5077,1805,73.77,26.23
Curitiba,2016,7,10520,6639,3881,63.11,36.89
Curitiba,2016,8,8908,6389,2519,71.72,28.28
Curitiba,2016,9,9016,6099,2917,67.65,32.35
Curitiba,2016,10,10885,8577,2308,78.8,21.2
Curitiba,2016,11,5212,3642,1570,69.88,30.12
Curitiba,2016,12,5443,4252,1191,78.12,21.88
Curitiba,2017,1,7036,5103,1933,72.53,27.47
Curitiba,2017,2,5215,4060,1155,77.85,22.15
Curitiba,2017,3,7173,5281,1892,73.62,26.38
Curitiba,2017,4,5670,4350,1320,76.72,23.28
Curitiba,2017,5,6450,5423,1027,84.08,15.92
Curitiba,2017,6,8446,7398,1048,87.59,12.41
Curitiba,2017,7,8956,7110,1846,79.39,20.61
Curitiba,2017,8,9288,8019,1269,86.34,13.66
Curitiba,2017,9,8535,6855,1680,80.32,19.68
Curitiba,2017,10,8451,7165,1286,84.78,15.22
Curitiba,2017,11,8009,6673,1336,83.32,16.68
Curitiba,2017,12,6891,5753,1138,83.49,16.51
Curitiba,2018,1,7666,6572,1094,85.73,14.27
Curitiba,2018,2,6067,5251,816,86.55,13.45
Curitiba,2018,3,6756,5904,852,87.39,12.61
Curitiba,2018,4,5621,4660,961,82.9,17.1
Curitiba,2018,5,4849,4276,573,88.18,11.82
Curitiba,2018,6,5022,4295,727,85.52,14.48
Curitiba,2018,7,5388,4674,714,86.75,13.25
Curitiba,2018,8,4970,4631,339,93.18,6.82
Curitiba,2018,9,4587,4086,501,89.08,10.92
Curitiba,2018,10,6339,5473,866,86.34,13.66
Curitiba,2018,11,6355,5471,884,86.09,13.91
Curitiba,2018,12,4866,4076,790,83.76,16.24
Curitiba,2019,1,5354,4838,516,90.36,9.64
Curitiba,2019,2,4689,4182,507,89.19,10.81
Curitiba,2019,3,4708,3924,784,83.35,16.65
Curitiba,2019,4,4890,4185,705,85.58,14.42
Curitiba,2019,5,4352,3651,701,83.89,16.11
Curitiba,2019,6,3883,3264,619,84.06,15.94
Curitiba,2019,7,4677,3783,894,80.89,19.11
Curitiba,2019,8,3816,3510,306,91.98,8.02
Curitiba,2019,9,3775,3404,371,90.17,9.83
Curitiba,2019,10,4571,4040,531,88.38,11.62
Curitiba,2019,11,0,0,0,0.0,0.0
Curitiba,2019,12,0,0,0,0.0,0.0
DOM. ANJOS ANEXO,2016,1,0,0,0,0.0,0.0
DOM. ANJOS ANEXO,2016,2,0,0,0,0.0,0.0
DOM. ANJOS ANEXO,2016,3,0,0,0,0.0,0.0
DOM. ANJOS ANEXO,2016,4,0,0,0,0.0,0.0
DOM. ANJOS ANEXO,2016,5,0,0,0,0.0,0.0
DOM. ANJOS ANEXO,2016,6,5,0,5,0.0,100.0
DOM. ANJOS ANEXO,2016,7,343,13,330,3.79,96.21
DOM. ANJOS ANEXO,2016,8,477,22,455,4.61,95.39
DOM. ANJOS ANEXO,2016,9,350,35,315,10.0,90.0
DOM. ANJOS ANEXO,2016,10,364,25,339,6.87,93.13
DOM. ANJOS ANEXO,2016,11,517,24,493,4.64,95.36
DOM. ANJOS ANEXO,2016,12,382,31,351,8.12,91.88
DOM. ANJOS ANEXO,2017,1,445,83,362,18.65,81.35
DOM. ANJOS ANEXO,2017,2,428,106,322,24.77,75.23
DOM. ANJOS ANEXO,2017,3,417,87,330,20.86,79.14
DOM. ANJOS ANEXO,2017,4,356,72,284,20.22,79.78
DOM. ANJOS ANEXO,2017,5,410,60,350,14.63,85.37
DOM. ANJOS ANEXO,2017,6,406,93,313,22.91,77.09
DOM. ANJOS ANEXO,2017,7,361,136,225,37.67,62.33
DOM. ANJOS ANEXO,2017,8,342,100,242,29.24,70.76
DOM. ANJOS ANEXO,2017,9,164,44,120,26.83,73.17
DOM. ANJOS ANEXO,2017,10,133,32,101,24.06,75.94
DOM. ANJOS ANEXO,2017,11,169,72,97,42.6,57.4
DOM. ANJOS ANEXO,2017,12,105,5,100,4.76,95.24
DOM. ANJOS ANEXO,2018,1,144,14,130,9.72,90.28
DOM. ANJOS ANEXO,2018,2,93,14,79,15.05,84.95
DOM. ANJOS ANEXO,2018,3,109,9,100,8.26,91.74
DOM. ANJOS ANEXO,2018,4,125,17,108,13.6,86.4
DOM. ANJOS ANEXO,2018,5,119,1,118,0.84,99.16
DOM. ANJOS ANEXO,2018,6,150,6,144,4.0,96.0
DOM. ANJOS ANEXO,2018,7,182,6,176,3.3,96.7
DOM. ANJOS ANEXO,2018,8,188,1,187,0.53,99.47
DOM. ANJOS ANEXO,2018,9,161,1,160,0.62,99.38
DOM. ANJOS ANEXO,2018,10,199,3,196,1.51,98.49
DOM. ANJOS ANEXO,2018,11,144,6,138,4.17,95.83
DOM. ANJOS ANEXO,2018,12,121,11,110,9.09,90.91
DOM. ANJOS ANEXO,2019,1,169,17,152,10.06,89.94
DOM. ANJOS ANEXO,2019,2,186,8,178,4.3,95.7
DOM. ANJOS ANEXO,2019,3,131,1,130,0.76,99.24
DOM. ANJOS ANEXO,2019,4,168,20,148,11.9,88.1
DOM. ANJOS ANEXO,2019,5,166,11,155,6.63,93.37
DOM. ANJOS ANEXO,2019,6,138,2,136,1.45,98.55
DOM. ANJOS ANEXO,2019,7,228,20,208,8.77,91.23
DOM. ANJOS ANEXO,2019,8,184,2,182,1.09,98.91
DOM. ANJOS ANEXO,2019,9,175,1,174,0.57,99.43
DOM. ANJOS ANEXO,2019,10,113,10,103,8.85,91.15
DOM. ANJOS ANEXO,2019,11,0,0,0,0.0,0.0
DOM. ANJOS ANEXO,2019,12,0,0,0,0.0,0.0
Florianópolis,2015,1,107,105,2,98.13,1.87
Florianópolis,2015,2,211,208,3,98.58,1.42
Florianópolis,2015,3,211,208,3,98.58,1.42
Florianópolis,2015,4,1593,1588,5,99.69,0.31
Florianópolis,2015,5,2933,2673,260,91.14,8.86
Florianópolis,2015,6,4864,4082,782,83.92,16.08
Florianópolis,2015,7,4275,4033,242,94.34,5.66
Florianópolis,2015,8,3584,3395,189,94.73,5.27
Florianópolis,2015,9,5054,3984,1070,78.83,21.17
Florianópolis,2015,10,3910,3788,122,96.88,3.12
Florianópolis,2015,11,4231,3857,374,91.16,8.84
Florianópolis,2015,12,3745,3618,127,96.61,3.39
Florianópolis,2016,1,4761,3423,1338,71.9,28.1
Florianópolis,2016,2,3611,3259,352,90.25,9.75
Florianópolis,2016,3,5931,4381,1550,73.87,26.13
Florianópolis,2016,4,4735,3534,1201,74.64,25.36
Florianópolis,2016,5,5006,4234,772,84.58,15.42
Florianópolis,2016,6,4970,4019,951,80.87,19.13
Florianópolis,2016,7,8773,4986,3787,56.83,43.17
Florianópolis,2016,8,7007,4907,2100,70.03,29.97
Florianópolis,2016,9,6988,4886,2102,69.92,30.08
Florianópolis,2016,10,7113,5384,1729,75.69,24.31
Florianópolis,2016,11,3806,2937,869,77.17,22.83
Florianópolis,2016,12,3681,2986,695,81.12,18.88
Florianópolis,2017,1,5060,3679,1381,72.71,27.29
Florianópolis,2017,2,4076,3362,714,82.48,17.52
Florianópolis,2017,3,5263,4184,1079,79.5,20.5
Florianópolis,2017,4,4309,3435,874,79.72,20.28
Florianópolis,2017,5,4775,4158,617,87.08,12.92
Florianópolis,2017,6,6035,5253,782,87.04,12.96
Florianópolis,2017,7,6533,4977,1556,76.18,23.82
Florianópolis,2017,8,8139,5676,2463,69.74,30.26
Florianópolis,2017,9,6417,4944,1473,77.05,22.95
Florianópolis,2017,10,6406,5511,895,86.03,13.97
Florianópolis,2017,11,5672,5125,547,90.36,9.64
Florianópolis,2017,12,5008,4234,774,84.54,15.46
Florianópolis,2018,1,6625,5605,1020,84.6,15.4
Florianópolis,2018,2,4321,3676,645,85.07,14.93
Florianópolis,2018,3,4944,4230,714,85.56,14.44
Florianópolis,2018,4,4243,3452,791,81.36,18.64
Florianópolis,2018,5,3733,3107,626,83.23,16.77
Florianópolis,2018,6,3616,2934,682,81.14,18.86
Florianópolis,2018,7,4248,3504,744,82.49,17.51
Florianópolis,2018,8,3676,3186,490,86.67,13.33
Florianópolis,2018,9,3447,2844,603,82.51,17.49
Florianópolis,2018,10,4208,3390,818,80.56,19.44
Florianópolis,2018,11,3969,3493,476,88.01,11.99
Florianópolis,2018,12,3333,2724,609,81.73,18.27
Florianópolis,2019,1,3426,2928,498,85.46,14.54
Florianópolis,2019,2,3251,2682,569,82.5,17.5
Florianópolis,2019,3,3162,2468,694,78.05,21.95
Florianópolis,2019,4,3026,2526,500,83.48,16.52
Florianópolis,2019,5,2773,2194,579,79.12,20.88
Florianópolis,2019,6,2687,2106,581,78.38,21.62
Florianópolis,2019,7,3003,2310,693,76.92,23.08
Florianópolis,2019,8,2563,2288,275,89.27,10.73
Florianópolis,2019,9,2613,2356,257,90.16,9.84
Florianópolis,2019,10,2961,2543,418,85.88,14.12
Florianópolis,2019,11,0,0,0,0.0,0.0
Florianópolis,2019,12,0,0,0,0.0,0.0
Fortaleza,2015,1,20,20,0,100.0,0.0
Fortaleza,2015,2,2,2,0,100.0,0.0
Fortaleza,2015,3,17,17,0,100.0,0.0
Fortaleza,2015,4,169,169,0,100.0,0.0
Fortaleza,2015,5,3267,3267,0,100.0,0.0
Fortaleza,2015,6,4700,4700,0,100.0,0.0
Fortaleza,2015,7,5274,5274,0,100.0,0.0
Fortaleza,2015,8,4479,4479,0,100.0,0.0
Fortaleza,2015,9,4860,4860,0,100.0,0.0
Fortaleza,2015,10,5164,5164,0,100.0,0.0
Fortaleza,2015,11,5508,5508,0,100.0,0.0
Fortaleza,2015,12,5041,4988,53,98.95,1.05
Fortaleza,2016,1,5641,5450,191,96.61,3.39
Fortaleza,2016,2,5166,5093,73,98.59,1.41
Fortaleza,2016,3,6982,6777,205,97.06,2.94
Fortaleza,2016,4,6723,5688,1035,84.61,15.39
Fortaleza,2016,5,6850,5780,1070,84.38,15.62
Fortaleza,2016,6,6413,5691,722,88.74,11.26
Fortaleza,2016,7,6430,5561,869,86.49,13.51
Fortaleza,2016,8,8521,7595,926,89.13,10.87
Fortaleza,2016,9,8666,7644,1022,88.21,11.79
Fortaleza,2016,10,9074,5895,3179,64.97,35.03
Fortaleza,2016,11,6203,3787,2416,61.05,38.95
Fortaleza,2016,12,5114,4062,1052,79.43,20.57
Fortaleza,2017,1,10026,5610,4416,55.95,44.05
Fortaleza,2017,2,5006,4336,670,86.62,13.38
Fortaleza,2017,3,10340,6503,3837,62.89,37.11
Fortaleza,2017,4,6888,4509,2379,65.46,34.54
Fortaleza,2017,5,8025,5676,2349,70.73,29.27
Fortaleza,2017,6,8703,6643,2060,76.33,23.67
Fortaleza,2017,7,8726,6328,2398,72.52,27.48
Fortaleza,2017,8,10081,6883,3198,68.28,31.72
Fortaleza,2017,9,7235,6005,1230,83.0,17.0
Fortaleza,2017,10,7218,6069,1149,84.08,15.92
Fortaleza,2017,11,7184,6278,906,87.39,12.61
Fortaleza,2017,12,6222,5464,758,87.82,12.18
Fortaleza,2018,1,7199,6208,991,86.23,13.77
Fortaleza,2018,2,9302,6342,2960,68.18,31.82
Fortaleza,2018,3,7726,5874,1852,76.03,23.97
Fortaleza,2018,4,6220,5239,981,84.23,15.77
Fortaleza,2018,5,8961,7940,1021,88.61,11.39
Fortaleza,2018,6,5159,4493,666,87.09,12.91
Fortaleza,2018,7,6012,5149,863,85.65,14.35
Fortaleza,2018,8,6193,5366,827,86.65,13.35
Fortaleza,2018,9,5093,4691,402,92.11,7.89
Fortaleza,2018,10,5950,5253,697,88.29,11.71
Fortaleza,2018,11,5447,4842,605,88.89,11.11
Fortaleza,2018,12,5567,4449,1118,79.92,20.08
Fortaleza,2019,1,5633,5008,625,88.9,11.1
Fortaleza,2019,2,5183,4674,509,90.18,9.82
Fortaleza,2019,3,4922,4165,757,84.62,15.38
Fortaleza,2019,4,5549,5068,481,91.33,8.67
Fortaleza,2019,5,4873,4301,572,88.26,11.74
Fortaleza,2019,6,4099,3627,472,88.48,11.52
Fortaleza,2019,7,5176,4213,963,81.39,18.61
Fortaleza,2019,8,4248,3664,584,86.25,13.75
Fortaleza,2019,9,4307,3602,705,83.63,16.37
Fortaleza,2019,10,4754,4134,620,86.96,13.04
Fortaleza,2019,11,0,0,0,0.0,0.0
Fortaleza,2019,12,0,0,0,0.0,0.0
Guarulhos,2015,1,1090,1078,12,98.9,1.1
Guarulhos,2015,2,472,472,0,100.0,0.0
Guarulhos,2015,3,394,393,1,99.75,0.25
Guarulhos,2015,4,2030,2019,11,99.46,0.54
Guarulhos,2015,5,3818,3453,365,90.44,9.56
Guarulhos,2015,6,6120,4786,1334,78.2,21.8
Guarulhos,2015,7,5824,5369,455,92.19,7.81
Guarulhos,2015,8,5204,4894,310,94.04,5.96
Guarulhos,2015,9,6464,5198,1266,80.41,19.59
Guarulhos,2015,10,5807,5588,219,96.23,3.77
Guarulhos,2015,11,6554,5927,627,90.43,9.57
Guarulhos,2015,12,6125,5064,1061,82.68,17.32
Guarulhos,2016,1,3920,3555,365,90.69,9.31
Guarulhos,2016,2,3917,3547,370,90.55,9.45
Guarulhos,2016,3,5842,4769,1073,81.63,18.37
Guarulhos,2016,4,5416,4143,1273,76.5,23.5
Guarulhos,2016,5,4870,3937,933,80.84,19.16
Guarulhos,2016,6,4835,4155,680,85.94,14.06
Guarulhos,2016,7,6436,4749,1687,73.79,26.21
Guarulhos,2016,8,8590,7107,1483,82.74,17.26
Guarulhos,2016,9,7869,6198,1671,78.76,21.24
Guarulhos,2016,10,5885,4431,1454,75.29,24.71
Guarulhos,2016,11,4418,3697,721,83.68,16.32
Guarulhos,2016,12,4170,3434,736,82.35,17.65
Guarulhos,2017,1,7353,4223,3130,57.43,42.57
Guarulhos,2017,2,4102,3454,648,84.2,15.8
Guarulhos,2017,3,7191,4467,2724,62.12,37.88
Guarulhos,2017,4,5140,3595,1545,69.94,30.06
Guarulhos,2017,5,5026,4602,424,91.56,8.44
Guarulhos,2017,6,5690,5292,398,93.01,6.99
Guarulhos,2017,7,7581,5787,1794,76.34,23.66
Guarulhos,2017,8,6557,5833,724,88.96,11.04
Guarulhos,2017,9,6845,5416,1429,79.12,20.88
Guarulhos,2017,10,6022,5125,897,85.1,14.9
Guarulhos,2017,11,4971,4680,291,94.15,5.85
Guarulhos,2017,12,4779,4256,523,89.06,10.94
Guarulhos,2018,1,5071,4498,573,88.7,11.3
Guarulhos,2018,2,4410,3907,503,88.59,11.41
Guarulhos,2018,3,4986,4430,556,88.85,11.15
Guarulhos,2018,4,4282,3743,539,87.41,12.59
Guarulhos,2018,5,4185,3825,360,91.4,8.6
Guarulhos,2018,6,3798,3354,444,88.31,11.69
Guarulhos,2018,7,4758,3950,808,83.02,16.98
Guarulhos,2018,8,4386,3694,692,84.22,15.78
Guarulhos,2018,9,4273,3441,832,80.53,19.47
Guarulhos,2018,10,5178,4666,512,90.11,9.89
Guarulhos,2018,11,4888,4445,443,90.94,9.06
Guarulhos,2018,12,3681,3204,477,87.04,12.96
Guarulhos,2019,1,4217,3798,419,90.06,9.94
Guarulhos,2019,2,4268,3864,404,90.53,9.47
Guarulhos,2019,3,4402,3721,681,84.53,15.47
Guarulhos,2019,4,3681,3459,222,93.97,6.03
Guarulhos,2019,5,3475,3200,275,92.09,7.91
Guarulhos,2019,6,2909,2715,194,93.33,6.67
Guarulhos,2019,7,3338,2960,378,88.68,11.32
Guarulhos,2019,8,2867,2709,158,94.49,5.51
Guarulhos,2019,9,2972,2803,169,94.31,5.69
Guarulhos,2019,10,3429,3157,272,92.07,7.93
Guarulhos,2019,11,0,0,0,0.0,0.0
Guarulhos,2019,12,0,0,0,0.0,0.0
Hortolandia,2015,1,2,2,0,100.0,0.0
Hortolandia,2015,2,0,0,0,0.0,0.0
Hortolandia,2015,3,6,6,0,100.0,0.0
Hortolandia,2015,4,32,32,0,100.0,0.0
Hortolandia,2015,5,1889,1889,0,100.0,0.0
Hortolandia,2015,6,3356,3356,0,100.0,0.0
Hortolandia,2015,7,3083,3083,0,100.0,0.0
Hortolandia,2015,8,3147,3147,0,100.0,0.0
Hortolandia,2015,9,2991,2991,0,100.0,0.0
Hortolandia,2015,10,3561,3560,1,99.97,0.03
Hortolandia,2015,11,2826,2826,0,100.0,0.0
Hortolandia,2015,12,2537,2537,0,100.0,0.0
Hortolandia,2016,1,2479,2474,5,99.8,0.2
Hortolandia,2016,2,3053,3028,25,99.18,0.82
Hortolandia,2016,3,4106,3952,154,96.25,3.75
Hortolandia,2016,4,2698,2194,504,81.32,18.68
Hortolandia,2016,5,2532,1858,674,73.38,26.62
Hortolandia,2016,6,2756,1881,875,68.25,31.75
Hortolandia,2016,7,2115,1577,538,74.56,25.44
Hortolandia,2016,8,3196,2364,832,73.97,26.03
Hortolandia,2016,9,2932,2209,723,75.34,24.66
Hortolandia,2016,10,2918,2211,707,75.77,24.23
Hortolandia,2016,11,3521,2660,861,75.55,24.45
Hortolandia,2016,12,4680,3575,1105,76.39,23.61
Hortolandia,2017,1,4471,3655,816,81.75,18.25
Hortolandia,2017,2,4457,3234,1223,72.56,27.44
Hortolandia,2017,3,6578,5265,1313,80.04,19.96
Hortolandia,2017,4,4871,3439,1432,70.6,29.4
Hortolandia,2017,5,3985,3086,899,77.44,22.56
Hortolandia,2017,6,4147,3536,611,85.27,14.73
Hortolandia,2017,7,4139,3546,593,85.67,14.33
Hortolandia,2017,8,4498,4141,357,92.06,7.94
Hortolandia,2017,9,3908,3646,262,93.3,6.7
Hortolandia,2017,10,4139,3820,319,92.29,7.71
Hortolandia,2017,11,4341,4053,288,93.37,6.63
Hortolandia,2017,12,2938,2671,267,90.91,9.09
Hortolandia,2018,1,2073,1932,141,93.2,6.8
Hortolandia,2018,2,2115,2008,107,94.94,5.06
Hortolandia,2018,3,1917,1750,167,91.29,8.71
Hortolandia,2018,4,1818,1682,136,92.52,7.48
Hortolandia,2018,5,1168,980,188,83.9,16.1
Hortolandia,2018,6,1762,1658,104,94.1,5.9
Hortolandia,2018,7,2604,2378,226,91.32,8.68
Hortolandia,2018,8,2599,2380,219,91.57,8.43
Hortolandia,2018,9,2110,1955,155,92.65,7.35
Hortolandia,2018,10,2081,1944,137,93.42,6.58
Hortolandia,2018,11,1961,1810,151,92.3,7.7
Hortolandia,2018,12,1678,1547,131,92.19,7.81
Hortolandia,2019,1,1997,1860,137,93.14,6.86
Hortolandia,2019,2,2123,1974,149,92.98,7.02
Hortolandia,2019,3,1955,1805,150,92.33,7.67
Hortolandia,2019,4,2346,2189,157,93.31,6.69
Hortolandia,2019,5,2076,1961,115,94.46,5.54
Hortolandia,2019,6,2487,2379,108,95.66,4.34
Hortolandia,2019,7,2551,2476,75,97.06,2.94
Hortolandia,2019,8,2660,2535,125,95.3,4.7
Hortolandia,2019,9,2248,2186,62,97.24,2.76
Hortolandia,2019,10,2374,2302,72,96.97,3.03
Hortolandia,2019,11,0,0,0,0.0,0.0
Hortolandia,2019,12,0,0,0,0.0,0.0
Lapa,2015,1,79,78,1,98.73,1.27
Lapa,2015,2,161,160,1,99.38,0.62
Lapa,2015,3,272,272,0,100.0,0.0
Lapa,2015,4,1280,1278,2,99.84,0.16
Lapa,2015,5,2751,2600,151,94.51,5.49
Lapa,2015,6,4354,4047,307,92.95,7.05
Lapa,2015,7,4134,3948,186,95.5,4.5
Lapa,2015,8,3819,3737,82,97.85,2.15
Lapa,2015,9,4826,4250,576,88.06,11.94
Lapa,2015,10,3773,3654,119,96.85,3.15
Lapa,2015,11,3931,3636,295,92.5,7.5
Lapa,2015,12,4101,3865,236,94.25,5.75
Lapa,2016,1,3540,3392,148,95.82,4.18
Lapa,2016,2,3127,2830,297,90.5,9.5
Lapa,2016,3,5467,4461,1006,81.6,18.4
Lapa,2016,4,5345,3913,1432,73.21,26.79
Lapa,2016,5,4915,4106,809,83.54,16.46
Lapa,2016,6,4640,3952,688,85.17,14.83
Lapa,2016,7,5789,4160,1629,71.86,28.14
Lapa,2016,8,7563,5858,1705,77.46,22.54
Lapa,2016,9,6537,4953,1584,75.77,24.23
Lapa,2016,10,5533,3887,1646,70.25,29.75
Lapa,2016,11,4675,3991,684,85.37,14.63
Lapa,2016,12,4024,3341,683,83.03,16.97
Lapa,2017,1,5056,3909,1147,77.31,22.69
Lapa,2017,2,3978,3420,558,85.97,14.03
Lapa,2017,3,4943,4166,777,84.28,15.72
Lapa,2017,4,4013,3284,729,81.83,18.17
Lapa,2017,5,2294,1753,541,76.42,23.58
Lapa,2017,6,3194,2846,348,89.1,10.9
Lapa,2017,7,3182,2455,727,77.15,22.85
Lapa,2017,8,2784,2495,289,89.62,10.38
Lapa,2017,9,2487,2132,355,85.73,14.27
Lapa,2017,10,2573,2053,520,79.79,20.21
Lapa,2017,11,4193,3905,288,93.13,6.87
Lapa,2017,12,4125,3581,544,86.81,13.19
Lapa,2018,1,4463,3771,692,84.49,15.51
Lapa,2018,2,3738,3335,403,89.22,10.78
Lapa,2018,3,4144,3688,456,89.0,11.0
Lapa,2018,4,3593,3091,502,86.03,13.97
Lapa,2018,5,3402,3085,317,90.68,9.32
Lapa,2018,6,3263,3013,250,92.34,7.66
Lapa,2018,7,3778,3281,497,86.84,13.16
Lapa,2018,8,4078,3438,640,84.31,15.69
Lapa,2018,9,3592,3018,574,84.02,15.98
Lapa,2018,10,3470,2992,478,86.22,13.78
Lapa,2018,11,2885,2773,112,96.12,3.88
Lapa,2018,12,2433,2203,230,90.55,9.45
Lapa,2019,1,2839,2694,145,94.89,5.11
Lapa,2019,2,2800,2634,166,94.07,5.93
Lapa,2019,3,2605,2381,224,91.4,8.6
Lapa,2019,4,2403,2279,124,94.84,5.16
Lapa,2019,5,2247,2098,149,93.37,6.63
Lapa,2019,6,1721,1624,97,94.36,5.64
Lapa,2019,7,2390,2217,173,92.76,7.24
Lapa,2019,8,2003,1916,87,95.66,4.34
Lapa,2019,9,2153,2070,83,96.14,3.86
Lapa,2019,10,2085,1908,177,91.51,8.49
Lapa,2019,11,1,1,0,100.0,0.0
Lapa,2019,12,0,0,0,0.0,0.0
Manaus,2015,1,136,136,0,100.0,0.0
Manaus,2015,2,36,36,0,100.0,0.0
Manaus,2015,3,25,25,0,100.0,0.0
Manaus,2015,4,181,181,0,100.0,0.0
Manaus,2015,5,2150,2150,0,100.0,0.0
Manaus,2015,6,3043,3042,1,99.97,0.03
Manaus,2015,7,3446,3446,0,100.0,0.0
Manaus,2015,8,3242,3242,0,100.0,0.0
Manaus,2015,9,2958,2958,0,100.0,0.0
Manaus,2015,10,3082,3081,1,99.97,0.03
Manaus,2015,11,3235,3234,1,99.97,0.03
Manaus,2015,12,3409,3397,12,99.65,0.35
Manaus,2016,1,4076,3864,212,94.8,5.2
Manaus,2016,2,3311,3292,19,99.43,0.57
Manaus,2016,3,4748,4129,619,86.96,13.04
Manaus,2016,4,4518,3395,1123,75.14,24.86
Manaus,2016,5,4892,3802,1090,77.72,22.28
Manaus,2016,6,4288,3483,805,81.23,18.77
Manaus,2016,7,4977,3983,994,80.03,19.97
Manaus,2016,8,5462,4493,969,82.26,17.74
Manaus,2016,9,5608,4287,1321,76.44,23.56
Manaus,2016,10,6723,4551,2172,67.69,32.31
Manaus,2016,11,4861,3472,1389,71.43,28.57
Manaus,2016,12,3692,2583,1109,69.96,30.04
Manaus,2017,1,7443,5084,2359,68.31,31.69
Manaus,2017,2,3686,2954,732,80.14,19.86
Manaus,2017,3,7603,5244,2359,68.97,31.03
Manaus,2017,4,5332,3856,1476,72.32,27.68
Manaus,2017,5,5900,4586,1314,77.73,22.27
Manaus,2017,6,6256,5515,741,88.16,11.84
Manaus,2017,7,6084,5199,885,85.45,14.55
Manaus,2017,8,6860,5685,1175,82.87,17.13
Manaus,2017,9,4926,3922,1004,79.62,20.38
Manaus,2017,10,5384,4045,1339,75.13,24.87
Manaus,2017,11,4375,3664,711,83.75,16.25
Manaus,2017,12,4349,3740,609,86.0,14.0
Manaus,2018,1,5124,4259,865,83.12,16.88
Manaus,2018,2,4212,3522,690,83.62,16.38
Manaus,2018,3,4590,3704,886,80.7,19.3
Manaus,2018,4,3965,3114,851,78.54,21.46
Manaus,2018,5,3728,3119,609,83.66,16.34
Manaus,2018,6,3301,2720,581,82.4,17.6
Manaus,2018,7,3863,3200,663,82.84,17.16
Manaus,2018,8,4022,3354,668,83.39,16.61
Manaus,2018,9,3270,2819,451,86.21,13.79
Manaus,2018,10,4178,3573,605,85.52,14.48
Manaus,2018,11,3647,2999,648,82.23,17.77
Manaus,2018,12,3379,2738,641,81.03,18.97
Manaus,2019,1,3540,3010,530,85.03,14.97
Manaus,2019,2,3125,2600,525,83.2,16.8
Manaus,2019,3,3095,2480,615,80.13,19.87
Manaus,2019,4,3429,2803,626,81.74,18.26
Manaus,2019,5,2871,2190,681,76.28,23.72
Manaus,2019,6,2597,1997,600,76.9,23.1
Manaus,2019,7,3046,2282,764,74.92,25.08
Manaus,2019,8,2775,2154,621,77.62,22.38
Manaus,2019,9,2450,1911,539,78.0,22.0
Manaus,2019,10,2568,1961,607,76.36,23.64
Manaus,2019,11,1,1,0,100.0,0.0
Manaus,2019,12,0,0,0,0.0,0.0
Niteroi,2015,1,6,6,0,100.0,0.0
Niteroi,2015,2,3,3,0,100.0,0.0
Niteroi,2015,3,18,18,0,100.0,0.0
Niteroi,2015,4,144,144,0,100.0,0.0
Niteroi,2015,5,2462,2462,0,100.0,0.0
Niteroi,2015,6,3507,3507,0,100.0,0.0
Niteroi,2015,7,3410,3410,0,100.0,0.0
Niteroi,2015,8,3302,3302,0,100.0,0.0
Niteroi,2015,9,3768,3768,0,100.0,0.0
Niteroi,2015,10,3458,3458,0,100.0,0.0
Niteroi,2015,11,3408,3408,0,100.0,0.0
Niteroi,2015,12,3872,3859,13,99.66,0.34
Niteroi,2016,1,4962,4592,370,92.54,7.46
Niteroi,2016,2,3659,3603,56,98.47,1.53
Niteroi,2016,3,5355,4651,704,86.85,13.15
Niteroi,2016,4,5291,3058,2233,57.8,42.2
Niteroi,2016,5,4874,3655,1219,74.99,25.01
Niteroi,2016,6,4373,3298,1075,75.42,24.58
Niteroi,2016,7,4896,3744,1152,76.47,23.53
Niteroi,2016,8,6242,4966,1276,79.56,20.44
Niteroi,2016,9,5212,4263,949,81.79,18.21
Niteroi,2016,10,7829,4193,3636,53.56,46.44
Niteroi,2016,11,4135,2517,1618,60.87,39.13
Niteroi,2016,12,4048,3029,1019,74.83,25.17
Niteroi,2017,1,7971,4062,3909,50.96,49.04
Niteroi,2017,2,4019,3214,805,79.97,20.03
Niteroi,2017,3,7739,4511,3228,58.29,41.71
Niteroi,2017,4,5791,3780,2011,65.27,34.73
Niteroi,2017,5,6847,5548,1299,81.03,18.97
Niteroi,2017,6,7987,6380,1607,79.88,20.12
Niteroi,2017,7,7863,5785,2078,73.57,26.43
Niteroi,2017,8,8797,6876,1921,78.16,21.84
Niteroi,2017,9,7129,5796,1333,81.3,18.7
Niteroi,2017,10,7073,5900,1173,83.42,16.58
Niteroi,2017,11,5653,5162,491,91.31,8.69
Niteroi,2017,12,4984,4542,442,91.13,8.87
Niteroi,2018,1,6485,5410,1075,83.42,16.58
Niteroi,2018,2,6420,5190,1230,80.84,19.16
Niteroi,2018,3,5598,4956,642,88.53,11.47
Niteroi,2018,4,5189,4379,810,84.39,15.61
Niteroi,2018,5,6122,4494,1628,73.41,26.59
Niteroi,2018,6,4530,4092,438,90.33,9.67
Niteroi,2018,7,5037,4451,586,88.37,11.63
Niteroi,2018,8,4816,4199,617,87.19,12.81
Niteroi,2018,9,4704,4089,615,86.93,13.07
Niteroi,2018,10,6903,4876,2027,70.64,29.36
Niteroi,2018,11,5416,4690,726,86.6,13.4
Niteroi,2018,12,4706,3983,723,84.64,15.36
Niteroi,2019,1,4663,3930,733,84.28,15.72
Niteroi,2019,2,4765,4022,743,84.41,15.59
Niteroi,2019,3,4577,3801,776,83.05,16.95
Niteroi,2019,4,4237,3656,581,86.29,13.71
Niteroi,2019,5,4319,3603,716,83.42,16.58
Niteroi,2019,6,3639,2959,680,81.31,18.69
Niteroi,2019,7,4579,3557,1022,77.68,22.32
Niteroi,2019,8,3750,3212,538,85.65,14.35
Niteroi,2019,9,3913,3506,407,89.6,10.4
Niteroi,2019,10,3860,3473,387,89.97,10.03
Niteroi,2019,11,0,0,0,0.0,0.0
Niteroi,2019,12,0,0,0,0.0,0.0
Paissandu,2015,1,313,283,30,90.42,9.58
Paissandu,2015,2,251,237,14,94.42,5.58
Paissandu,2015,3,383,369,14,96.34,3.66
Paissandu,2015,4,1645,1604,41,97.51,2.49
Paissandu,2015,5,3255,2989,266,91.83,8.17
Paissandu,2015,6,5493,4932,561,89.79,10.21
Paissandu,2015,7,5183,4900,283,94.54,5.46
Paissandu,2015,8,4938,4793,145,97.06,2.94
Paissandu,2015,9,6333,5351,982,84.49,15.51
Paissandu,2015,10,5520,5311,209,96.21,3.79
Paissandu,2015,11,5623,5159,464,91.75,8.25
Paissandu,2015,12,5346,5001,345,93.55,6.45
Paissandu,2016,1,4508,4288,220,95.12,4.88
Paissandu,2016,2,4005,3612,393,90.19,9.81
Paissandu,2016,3,6688,5419,1269,81.03,18.97
Paissandu,2016,4,6416,5080,1336,79.18,20.82
Paissandu,2016,5,5702,5071,631,88.93,11.07
Paissandu,2016,6,7010,5981,1029,85.32,14.68
Paissandu,2016,7,7697,5382,2315,69.92,30.08
Paissandu,2016,8,9813,8006,1807,81.59,18.41
Paissandu,2016,9,8382,6578,1804,78.48,21.52
Paissandu,2016,10,7406,5367,2039,72.47,27.53
Paissandu,2016,11,6229,5562,667,89.29,10.71
Paissandu,2016,12,5897,5381,516,91.25,8.75
Paissandu,2017,1,8489,7171,1318,84.47,15.53
Paissandu,2017,2,6944,6503,441,93.65,6.35
Paissandu,2017,3,9256,7892,1364,85.26,14.74
Paissandu,2017,4,7092,5982,1110,84.35,15.65
Paissandu,2017,5,9093,8211,882,90.3,9.7
Paissandu,2017,6,10770,10116,654,93.93,6.07
Paissandu,2017,7,13101,10762,2339,82.15,17.85
Paissandu,2017,8,13297,12169,1128,91.52,8.48
Paissandu,2017,9,11769,10119,1650,85.98,14.02
Paissandu,2017,10,10859,9788,1071,90.14,9.86
Paissandu,2017,11,9358,8981,377,95.97,4.03
Paissandu,2017,12,7641,7130,511,93.31,6.69
Paissandu,2018,1,6850,6119,731,89.33,10.67
Paissandu,2018,2,5733,5075,658,88.52,11.48
Paissandu,2018,3,6727,5717,1010,84.99,15.01
Paissandu,2018,4,5999,4909,1090,81.83,18.17
Paissandu,2018,5,5209,4643,566,89.13,10.87
Paissandu,2018,6,4709,4352,357,92.42,7.58
Paissandu,2018,7,5989,5228,761,87.29,12.71
Paissandu,2018,8,5937,5096,841,85.83,14.17
Paissandu,2018,9,4891,4324,567,88.41,11.59
Paissandu,2018,10,6294,5540,754,88.02,11.98
Paissandu,2018,11,5079,4784,295,94.19,5.81
Paissandu,2018,12,3981,3567,414,89.6,10.4
Paissandu,2019,1,4438,4105,333,92.5,7.5
Paissandu,2019,2,4191,4019,172,95.9,4.1
Paissandu,2019,3,4091,3670,421,89.71,10.29
Paissandu,2019,4,3746,3582,164,95.62,4.38
Paissandu,2019,5,3647,3366,281,92.3,7.7
Paissandu,2019,6,2910,2780,130,95.53,4.47
Paissandu,2019,7,3548,3299,249,92.98,7.02
Paissandu,2019,8,3281,3176,105,96.8,3.2
Paissandu,2019,9,3110,3021,89,97.14,2.86
Paissandu,2019,10,3687,3438,249,93.25,6.75
Paissandu,2019,11,0,0,0,0.0,0.0
Paissandu,2019,12,0,0,0,0.0,0.0
Paissandu Comercial,2018,1,0,0,0,0.0,0.0
Paissandu Comercial,2018,2,0,0,0,0.0,0.0
Paissandu Comercial,2018,3,1,1,0,100.0,0.0
Paissandu Comercial,2018,4,0,0,0,0.0,0.0
Paissandu Comercial,2018,5,0,0,0,0.0,0.0
Paissandu Comercial,2018,6,1,0,1,0.0,100.0
Paissandu Comercial,2018,7,30,10,20,33.33,66.67
Paissandu Comercial,2018,8,71,10,61,14.08,85.92
Paissandu Comercial,2018,9,582,328,254,56.36,43.64
Paissandu Comercial,2018,10,8762,6092,2670,69.53,30.47
Paissandu Comercial,2018,11,8370,5949,2421,71.08,28.92
Paissandu Comercial,2018,12,6703,5045,1658,75.26,24.74
Paissandu Comercial,2019,1,7660,5714,1946,74.6,25.4
Paissandu Comercial,2019,2,7441,5859,1582,78.74,21.26
Paissandu Comercial,2019,3,7646,5877,1769,76.86,23.14
Paissandu Comercial,2019,4,7817,6284,1533,80.39,19.61
Paissandu Comercial,2019,5,7723,6583,1140,85.24,14.76
Paissandu Comercial,2019,6,6607,5527,1080,83.65,16.35
Paissandu Comercial,2019,7,7855,6545,1310,83.32,16.68
Paissandu Comercial,2019,8,7284,6497,787,89.2,10.8
Paissandu Comercial,2019,9,7387,6879,508,93.12,6.88
Paissandu Comercial,2019,10,7069,6723,346,95.11,4.89
Paissandu Comercial,2019,11,0,0,0,0.0,0.0
Paissandu Comercial,2019,12,0,0,0,0.0,0.0
Porto Alegre,2015,1,163,162,1,99.39,0.61
Porto Alegre,2015,2,174,174,0,100.0,0.0
Porto Alegre,2015,3,281,273,8,97.15,2.85
Porto Alegre,2015,4,1404,1394,10,99.29,0.71
Porto Alegre,2015,5,2935,2715,220,92.5,7.5
Porto Alegre,2015,6,4587,3933,654,85.74,14.26
Porto Alegre,2015,7,4126,3802,324,92.15,7.85
Porto Alegre,2015,8,3712,3494,218,94.13,5.87
Porto Alegre,2015,9,4942,3770,1172,76.28,23.72
Porto Alegre,2015,10,3910,3782,128,96.73,3.27
Porto Alegre,2015,11,4189,3733,456,89.11,10.89
Porto Alegre,2015,12,3597,3363,234,93.49,6.51
Porto Alegre,2016,1,4516,3288,1228,72.81,27.19
Porto Alegre,2016,2,3725,3345,380,89.8,10.2
Porto Alegre,2016,3,5557,4271,1286,76.86,23.14
Porto Alegre,2016,4,4800,3613,1187,75.27,24.73
Porto Alegre,2016,5,4439,3870,569,87.18,12.82
Porto Alegre,2016,6,4652,3994,658,85.86,14.14
Porto Alegre,2016,7,6415,4424,1991,68.96,31.04
Porto Alegre,2016,8,6459,4548,1911,70.41,29.59
Porto Alegre,2016,9,6724,4875,1849,72.5,27.5
Porto Alegre,2016,10,5914,4394,1520,74.3,25.7
Porto Alegre,2016,11,3487,2873,614,82.39,17.61
Porto Alegre,2016,12,3448,2891,557,83.85,16.15
Porto Alegre,2017,1,4890,3669,1221,75.03,24.97
Porto Alegre,2017,2,3791,3221,570,84.96,15.04
Porto Alegre,2017,3,5137,3998,1139,77.83,22.17
Porto Alegre,2017,4,4124,3299,825,80.0,20.0
Porto Alegre,2017,5,5059,4425,634,87.47,12.53
Porto Alegre,2017,6,5610,4950,660,88.24,11.76
Porto Alegre,2017,7,6083,4849,1234,79.71,20.29
Porto Alegre,2017,8,7857,5541,2316,70.52,29.48
Porto Alegre,2017,9,5828,4539,1289,77.88,22.12
Porto Alegre,2017,10,6417,5390,1027,84.0,16.0
Porto Alegre,2017,11,4803,4177,626,86.97,13.03
Porto Alegre,2017,12,4400,3671,729,83.43,16.57
Porto Alegre,2018,1,4996,4184,812,83.75,16.25
Porto Alegre,2018,2,3732,3142,590,84.19,15.81
Porto Alegre,2018,3,4216,3613,603,85.7,14.3
Porto Alegre,2018,4,3966,3332,634,84.01,15.99
Porto Alegre,2018,5,3572,2984,588,83.54,16.46
Porto Alegre,2018,6,3760,3032,728,80.64,19.36
Porto Alegre,2018,7,4109,3266,843,79.48,20.52
Porto Alegre,2018,8,3954,3431,523,86.77,13.23
Porto Alegre,2018,9,3248,2712,536,83.5,16.5
Porto Alegre,2018,10,4310,3560,750,82.6,17.4
Porto Alegre,2018,11,4011,3398,613,84.72,15.28
Porto Alegre,2018,12,3521,2586,935,73.45,26.55
Porto Alegre,2019,1,3448,2958,490,85.79,14.21
Porto Alegre,2019,2,3122,2637,485,84.47,15.53
Porto Alegre,2019,3,3135,2415,720,77.03,22.97
Porto Alegre,2019,4,3511,2577,934,73.4,26.6
Porto Alegre,2019,5,3635,2639,996,72.6,27.4
Porto Alegre,2019,6,3117,2373,744,76.13,23.87
Porto Alegre,2019,7,3682,2690,992,73.06,26.94
Porto Alegre,2019,8,3070,2501,569,81.47,18.53
Porto Alegre,2019,9,2976,2472,504,83.06,16.94
Porto Alegre,2019,10,3072,2488,584,80.99,19.01
Porto Alegre,2019,11,0,0,0,0.0,0.0
Porto Alegre,2019,12,0,0,0,0.0,0.0
Recife,2015,1,72,72,0,100.0,0.0
Recife,2015,2,6,6,0,100.0,0.0
Recife,2015,3,7,7,0,100.0,0.0
Recife,2015,4,165,165,0,100.0,0.0
Recife,2015,5,3299,3299,0,100.0,0.0
Recife,2015,6,3816,3816,0,100.0,0.0
Recife,2015,7,5000,5000,0,100.0,0.0
Recife,2015,8,5048,5048,0,100.0,0.0
Recife,2015,9,4225,4225,0,100.0,0.0
Recife,2015,10,3841,3840,1,99.97,0.03
Recife,2015,11,4235,4235,0,100.0,0.0
Recife,2015,12,4710,4578,132,97.2,2.8
Recife,2016,1,4289,4119,170,96.04,3.96
Recife,2016,2,3919,3612,307,92.17,7.83
Recife,2016,3,5656,5432,224,96.04,3.96
Recife,2016,4,5746,4908,838,85.42,14.58
Recife,2016,5,6001,5265,736,87.74,12.26
Recife,2016,6,5428,4759,669,87.68,12.32
Recife,2016,7,5674,4825,849,85.04,14.96
Recife,2016,8,6938,6076,862,87.58,12.42
Recife,2016,9,7545,6731,814,89.21,10.79
Recife,2016,10,7434,5058,2376,68.04,31.96
Recife,2016,11,5484,3446,2038,62.84,37.16
Recife,2016,12,4175,3466,709,83.02,16.98
Recife,2017,1,8033,4917,3116,61.21,38.79
Recife,2017,2,4161,3637,524,87.41,12.59
Recife,2017,3,8064,4921,3143,61.02,38.98
Recife,2017,4,5609,3931,1678,70.08,29.92
Recife,2017,5,6453,4719,1734,73.13,26.87
Recife,2017,6,7871,5919,1952,75.2,24.8
Recife,2017,7,7809,6448,1361,82.57,17.43
Recife,2017,8,9260,7791,1469,84.14,15.86
Recife,2017,9,6896,6585,311,95.49,4.51
Recife,2017,10,8251,7308,943,88.57,11.43
Recife,2017,11,8854,8117,737,91.68,8.32
Recife,2017,12,7345,6256,1089,85.17,14.83
Recife,2018,1,8844,8067,777,91.21,8.79
Recife,2018,2,8010,5543,2467,69.2,30.8
Recife,2018,3,7155,6228,927,87.04,12.96
Recife,2018,4,6013,5306,707,88.24,11.76
Recife,2018,5,5770,5169,601,89.58,10.42
Recife,2018,6,5548,5170,378,93.19,6.81
Recife,2018,7,6015,5595,420,93.02,6.98
Recife,2018,8,5840,5328,512,91.23,8.77
Recife,2018,9,5202,4872,330,93.66,6.34
Recife,2018,10,5747,5256,491,91.46,8.54
Recife,2018,11,4874,4360,514,89.45,10.55
Recife,2018,12,5595,4513,1082,80.66,19.34
Recife,2019,1,5433,4772,661,87.83,12.17
Recife,2019,2,5040,4428,612,87.86,12.14
Recife,2019,3,4615,3933,682,85.22,14.78
Recife,2019,4,5076,4674,402,92.08,7.92
Recife,2019,5,4604,4249,355,92.29,7.71
Recife,2019,6,3939,3541,398,89.9,10.1
Recife,2019,7,4871,4209,662,86.41,13.59
Recife,2019,8,4350,3899,451,89.63,10.37
Recife,2019,9,4045,3623,422,89.57,10.43
Recife,2019,10,4125,3749,376,90.88,9.12
Recife,2019,11,0,0,0,0.0,0.0
Recife,2019,12,0,0,0,0.0,0.0
Ribeirão Preto,2015,1,843,836,7,99.17,0.83
Ribeirão Preto,2015,2,325,324,1,99.69,0.31
Ribeirão Preto,2015,3,264,262,2,99.24,0.76
Ribeirão Preto,2015,4,1240,1230,10,99.19,0.81
Ribeirão Preto,2015,5,2522,2236,286,88.66,11.34
Ribeirão Preto,2015,6,4065,3102,963,76.31,23.69
Ribeirão Preto,2015,7,3740,3410,330,91.18,8.82
Ribeirão Preto,2015,8,3649,3405,244,93.31,6.69
Ribeirão Preto,2015,9,4634,3804,830,82.09,17.91
Ribeirão Preto,2015,10,3669,3533,136,96.29,3.71
Ribeirão Preto,2015,11,4125,3564,561,86.4,13.6
Ribeirão Preto,2015,12,4182,3689,493,88.21,11.79
Ribeirão Preto,2016,1,4885,4109,776,84.11,15.89
Ribeirão Preto,2016,2,4328,3694,634,85.35,14.65
Ribeirão Preto,2016,3,5927,4619,1308,77.93,22.07
Ribeirão Preto,2016,4,5651,4187,1464,74.09,25.91
Ribeirão Preto,2016,5,5307,4462,845,84.08,15.92
Ribeirão Preto,2016,6,4939,4366,573,88.4,11.6
Ribeirão Preto,2016,7,6480,4765,1715,73.53,26.47
Ribeirão Preto,2016,8,6684,5295,1389,79.22,20.78
Ribeirão Preto,2016,9,7424,5841,1583,78.68,21.32
Ribeirão Preto,2016,10,6892,5293,1599,76.8,23.2
Ribeirão Preto,2016,11,3994,3137,857,78.54,21.46
Ribeirão Preto,2016,12,4201,3719,482,88.53,11.47
Ribeirão Preto,2017,1,7770,5123,2647,65.93,34.07
Ribeirão Preto,2017,2,4124,3694,430,89.57,10.43
Ribeirão Preto,2017,3,7616,5539,2077,72.73,27.27
Ribeirão Preto,2017,4,5490,4268,1222,77.74,22.26
Ribeirão Preto,2017,5,5736,5032,704,87.73,12.27
Ribeirão Preto,2017,6,6988,5865,1123,83.93,16.07
Ribeirão Preto,2017,7,7058,5921,1137,83.89,16.11
Ribeirão Preto,2017,8,7600,6555,1045,86.25,13.75
Ribeirão Preto,2017,9,7143,5666,1477,79.32,20.68
Ribeirão Preto,2017,10,6893,5907,986,85.7,14.3
Ribeirão Preto,2017,11,5754,5259,495,91.4,8.6
Ribeirão Preto,2017,12,5734,4980,754,86.85,13.15
Ribeirão Preto,2018,1,5897,5218,679,88.49,11.51
Ribeirão Preto,2018,2,5610,4425,1185,78.88,21.12
Ribeirão Preto,2018,3,5258,4632,626,88.09,11.91
Ribeirão Preto,2018,4,5104,4376,728,85.74,14.26
Ribeirão Preto,2018,5,4089,3602,487,88.09,11.91
Ribeirão Preto,2018,6,3969,3493,476,88.01,11.99
Ribeirão Preto,2018,7,4435,3896,539,87.85,12.15
Ribeirão Preto,2018,8,4221,3857,364,91.38,8.62
Ribeirão Preto,2018,9,3787,3422,365,90.36,9.64
Ribeirão Preto,2018,10,4978,4430,548,88.99,11.01
Ribeirão Preto,2018,11,4738,4363,375,92.09,7.91
Ribeirão Preto,2018,12,3680,3332,348,90.54,9.46
Ribeirão Preto,2019,1,3930,3607,323,91.78,8.22
Ribeirão Preto,2019,2,3825,3486,339,91.14,8.86
Ribeirão Preto,2019,3,3545,3294,251,92.92,7.08
Ribeirão Preto,2019,4,3679,3404,275,92.53,7.47
Ribeirão Preto,2019,5,3187,2893,294,90.78,9.22
Ribeirão Preto,2019,6,2795,2539,256,90.84,9.16
Ribeirão Preto,2019,7,3468,3191,277,92.01,7.99
Ribeirão Preto,2019,8,3018,2755,263,91.29,8.71
Ribeirão Preto,2019,9,2950,2787,163,94.47,5.53
Ribeirão Preto,2019,10,3509,3280,229,93.47,6.53
Ribeirão Preto,2019,11,0,0,0,0.0,0.0
Ribeirão Preto,2019,12,0,0,0,0.0,0.0
Rio de Janeiro,2015,1,4,4,0,100.0,0.0
Rio de Janeiro,2015,2,43,43,0,100.0,0.0
Rio de Janeiro,2015,3,11,11,0,100.0,0.0
Rio de Janeiro,2015,4,50,50,0,100.0,0.0
Rio de Janeiro,2015,5,2667,2667,0,100.0,0.0
Rio de Janeiro,2015,6,3778,3778,0,100.0,0.0
Rio de Janeiro,2015,7,4346,4346,0,100.0,0.0
Rio de Janeiro,2015,8,4365,4365,0,100.0,0.0
Rio de Janeiro,2015,9,4955,4955,0,100.0,0.0
Rio de Janeiro,2015,10,4458,4458,0,100.0,0.0
Rio de Janeiro,2015,11,4371,4371,0,100.0,0.0
Rio de Janeiro,2015,12,4841,4834,7,99.86,0.14
Rio de Janeiro,2016,1,5865,5606,259,95.58,4.42
Rio de Janeiro,2016,2,4434,4412,22,99.5,0.5
Rio de Janeiro,2016,3,6317,5726,591,90.64,9.36
Rio de Janeiro,2016,4,6290,4150,2140,65.98,34.02
Rio de Janeiro,2016,5,5822,4942,880,84.88,15.12
Rio de Janeiro,2016,6,5171,4499,672,87.0,13.0
Rio de Janeiro,2016,7,6122,5268,854,86.05,13.95
Rio de Janeiro,2016,8,8052,7172,880,89.07,10.93
Rio de Janeiro,2016,9,6987,6486,501,92.83,7.17
Rio de Janeiro,2016,10,7658,4901,2757,64.0,36.0
Rio de Janeiro,2016,11,5445,4137,1308,75.98,24.02
Rio de Janeiro,2016,12,4785,4052,733,84.68,15.32
Rio de Janeiro,2017,1,8260,4438,3822,53.73,46.27
Rio de Janeiro,2017,2,4755,3683,1072,77.46,22.54
Rio de Janeiro,2017,3,8638,4897,3741,56.69,43.31
Rio de Janeiro,2017,4,6615,4585,2030,69.31,30.69
Rio de Janeiro,2017,5,7684,6248,1436,81.31,18.69
Rio de Janeiro,2017,6,8338,6753,1585,80.99,19.01
Rio de Janeiro,2017,7,7951,6528,1423,82.1,17.9
Rio de Janeiro,2017,8,10234,7709,2525,75.33,24.67
Rio de Janeiro,2017,9,8501,6702,1799,78.84,21.16
Rio de Janeiro,2017,10,7859,6465,1394,82.26,17.74
Rio de Janeiro,2017,11,6236,5809,427,93.15,6.85
Rio de Janeiro,2017,12,5697,5189,508,91.08,8.92
Rio de Janeiro,2018,1,6878,5875,1003,85.42,14.58
Rio de Janeiro,2018,2,6783,5660,1123,83.44,16.56
Rio de Janeiro,2018,3,5765,5135,630,89.07,10.93
Rio de Janeiro,2018,4,5274,4545,729,86.18,13.82
Rio de Janeiro,2018,5,5391,4548,843,84.36,15.64
Rio de Janeiro,2018,6,4965,4331,634,87.23,12.77
Rio de Janeiro,2018,7,5244,4654,590,88.75,11.25
Rio de Janeiro,2018,8,5085,4498,587,88.46,11.54
Rio de Janeiro,2018,9,4609,4149,460,90.02,9.98
Rio de Janeiro,2018,10,6106,5295,811,86.72,13.28
Rio de Janeiro,2018,11,5390,4975,415,92.3,7.7
Rio de Janeiro,2018,12,4404,3867,537,87.81,12.19
Rio de Janeiro,2019,1,5134,4472,662,87.11,12.89
Rio de Janeiro,2019,2,4776,4448,328,93.13,6.87
Rio de Janeiro,2019,3,4691,4059,632,86.53,13.47
Rio de Janeiro,2019,4,4554,4202,352,92.27,7.73
Rio de Janeiro,2019,5,4522,4151,371,91.8,8.2
Rio de Janeiro,2019,6,3785,3490,295,92.21,7.79
Rio de Janeiro,2019,7,4645,4130,515,88.91,11.09
Rio de Janeiro,2019,8,3813,3590,223,94.15,5.85
Rio de Janeiro,2019,9,3553,3382,171,95.19,4.81
Rio de Janeiro,2019,10,4134,3849,285,93.11,6.89
Rio de Janeiro,2019,11,1,0,1,0.0,100.0
Rio de Janeiro,2019,12,0,0,0,0.0,0.0
Salvador,2015,1,194,194,0,100.0,0.0
Salvador,2015,2,31,31,0,100.0,0.0
Salvador,2015,3,85,85,0,100.0,0.0
Salvador,2015,4,328,327,1,99.7,0.3
Salvador,2015,5,5525,5525,0,100.0,0.0
Salvador,2015,6,6943,6943,0,100.0,0.0
Salvador,2015,7,8604,8604,0,100.0,0.0
Salvador,2015,8,8524,8523,1,99.99,0.01
Salvador,2015,9,8027,8027,0,100.0,0.0
Salvador,2015,10,7209,7209,0,100.0,0.0
Salvador,2015,11,8397,8395,2,99.98,0.02
Salvador,2015,12,8949,8826,123,98.63,1.37
Salvador,2016,1,9595,9233,362,96.23,3.77
Salvador,2016,2,7434,7087,347,95.33,4.67
Salvador,2016,3,10011,9537,474,95.27,4.73
Salvador,2016,4,10666,8831,1835,82.8,17.2
Salvador,2016,5,11786,9885,1901,83.87,16.13
Salvador,2016,6,10241,8761,1480,85.55,14.45
Salvador,2016,7,10582,9082,1500,85.82,14.18
Salvador,2016,8,14323,12607,1716,88.02,11.98
Salvador,2016,9,12389,10822,1567,87.35,12.65
Salvador,2016,10,14166,8637,5529,60.97,39.03
Salvador,2016,11,10339,6393,3946,61.83,38.17
Salvador,2016,12,7634,6147,1487,80.52,19.48
Salvador,2017,1,14982,9468,5514,63.2,36.8
Salvador,2017,2,8193,6964,1229,85.0,15.0
Salvador,2017,3,14839,9860,4979,66.45,33.55
Salvador,2017,4,11015,7393,3622,67.12,32.88
Salvador,2017,5,12477,8751,3726,70.14,29.86
Salvador,2017,6,14039,9993,4046,71.18,28.82
Salvador,2017,7,14767,10697,4070,72.44,27.56
Salvador,2017,8,16500,12919,3581,78.3,21.7
Salvador,2017,9,12355,10294,2061,83.32,16.68
Salvador,2017,10,12586,10808,1778,85.87,14.13
Salvador,2017,11,10594,9612,982,90.73,9.27
Salvador,2017,12,9631,8612,1019,89.42,10.58
Salvador,2018,1,10992,9435,1557,85.84,14.16
Salvador,2018,2,12080,9163,2917,75.85,24.15
Salvador,2018,3,10538,9116,1422,86.51,13.49
Salvador,2018,4,8997,7673,1324,85.28,14.72
Salvador,2018,5,9609,7711,1898,80.25,19.75
Salvador,2018,6,7952,6989,963,87.89,12.11
Salvador,2018,7,8858,7727,1131,87.23,12.77
Salvador,2018,8,8576,7768,808,90.58,9.42
Salvador,2018,9,8119,7217,902,88.89,11.11
Salvador,2018,10,9935,8290,1645,83.44,16.56
Salvador,2018,11,8302,7302,1000,87.95,12.05
Salvador,2018,12,7851,6508,1343,82.89,17.11
Salvador,2019,1,8378,7424,954,88.61,11.39
Salvador,2019,2,7686,6938,748,90.27,9.73
Salvador,2019,3,7407,6462,945,87.24,12.76
Salvador,2019,4,7226,6527,699,90.33,9.67
Salvador,2019,5,6568,5923,645,90.18,9.82
Salvador,2019,6,5430,4849,581,89.3,10.7
Salvador,2019,7,7176,6169,1007,85.97,14.03
Salvador,2019,8,6480,5981,499,92.3,7.7
Salvador,2019,9,6126,5676,450,92.65,7.35
Salvador,2019,10,6746,6111,635,90.59,9.41
Salvador,2019,11,1,0,1,0.0,100.0
Salvador,2019,12,0,0,0,0.0,0.0
São Bernardo do Campo,2015,1,1268,1249,19,98.5,1.5
São Bernardo do Campo,2015,2,542,542,0,100.0,0.0
São Bernardo do Campo,2015,3,547,544,3,99.45,0.55
São Bernardo do Campo,2015,4,2583,2564,19,99.26,0.74
São Bernardo do Campo,2015,5,5358,4978,380,92.91,7.09
São Bernardo do Campo,2015,6,7950,6488,1462,81.61,18.39
São Bernardo do Campo,2015,7,7394,6938,456,93.83,6.17
São Bernardo do Campo,2015,8,7598,7257,341,95.51,4.49
São Bernardo do Campo,2015,9,10104,8818,1286,87.27,12.73
São Bernardo do Campo,2015,10,8862,8629,233,97.37,2.63
São Bernardo do Campo,2015,11,8204,7578,626,92.37,7.63
São Bernardo do Campo,2015,12,7917,6814,1103,86.07,13.93
São Bernardo do Campo,2016,1,8348,7712,636,92.38,7.62
São Bernardo do Campo,2016,2,8294,7578,716,91.37,8.63
São Bernardo do Campo,2016,3,11958,9787,2171,81.84,18.16
São Bernardo do Campo,2016,4,11248,8539,2709,75.92,24.08
São Bernardo do Campo,2016,5,10182,8612,1570,84.58,15.42
São Bernardo do Campo,2016,6,9397,8101,1296,86.21,13.79
São Bernardo do Campo,2016,7,11124,8193,2931,73.65,26.35
São Bernardo do Campo,2016,8,14274,11662,2612,81.7,18.3
São Bernardo do Campo,2016,9,13626,11036,2590,80.99,19.01
São Bernardo do Campo,2016,10,12038,8743,3295,72.63,27.37
São Bernardo do Campo,2016,11,9396,7851,1545,83.56,16.44
São Bernardo do Campo,2016,12,7994,6278,1716,78.53,21.47
São Bernardo do Campo,2017,1,13895,7988,5907,57.49,42.51
São Bernardo do Campo,2017,2,7656,6324,1332,82.6,17.4
São Bernardo do Campo,2017,3,12748,7620,5128,59.77,40.23
São Bernardo do Campo,2017,4,9823,6849,2974,69.72,30.28
São Bernardo do Campo,2017,5,9475,7779,1696,82.1,17.9
São Bernardo do Campo,2017,6,9901,9099,802,91.9,8.1
São Bernardo do Campo,2017,7,13130,9342,3788,71.15,28.85
São Bernardo do Campo,2017,8,11385,10163,1222,89.27,10.73
São Bernardo do Campo,2017,9,11153,9206,1947,82.54,17.46
São Bernardo do Campo,2017,10,10751,9119,1632,84.82,15.18
São Bernardo do Campo,2017,11,8491,7997,494,94.18,5.82
São Bernardo do Campo,2017,12,8509,7462,1047,87.7,12.3
São Bernardo do Campo,2018,1,8913,7763,1150,87.1,12.9
São Bernardo do Campo,2018,2,7087,6237,850,88.01,11.99
São Bernardo do Campo,2018,3,8191,7089,1102,86.55,13.45
São Bernardo do Campo,2018,4,7193,6086,1107,84.61,15.39
São Bernardo do Campo,2018,5,6188,5634,554,91.05,8.95
São Bernardo do Campo,2018,6,6000,5369,631,89.48,10.52
São Bernardo do Campo,2018,7,7904,6357,1547,80.43,19.57
São Bernardo do Campo,2018,8,8136,6420,1716,78.91,21.09
São Bernardo do Campo,2018,9,7576,6097,1479,80.48,19.52
São Bernardo do Campo,2018,10,5261,4169,1092,79.24,20.76
São Bernardo do Campo,2018,11,4873,4442,431,91.16,8.84
São Bernardo do Campo,2018,12,3956,3396,560,85.84,14.16
São Bernardo do Campo,2019,1,4393,3893,500,88.62,11.38
São Bernardo do Campo,2019,2,3839,3476,363,90.54,9.46
São Bernardo do Campo,2019,3,3862,3363,499,87.08,12.92
São Bernardo do Campo,2019,4,3804,3442,362,90.48,9.52
São Bernardo do Campo,2019,5,3559,3241,318,91.06,8.94
São Bernardo do Campo,2019,6,3060,2731,329,89.25,10.75
São Bernardo do Campo,2019,7,3610,3086,524,85.48,14.52
São Bernardo do Campo,2019,8,3184,2884,300,90.58,9.42
São Bernardo do Campo,2019,9,3269,2953,316,90.33,9.67
São Bernardo do Campo,2019,10,3514,3199,315,91.04,8.96
São Bernardo do Campo,2019,11,0,0,0,0.0,0.0
São Bernardo do Campo,2019,12,0,0,0,0.0,0.0
São José dos Campos,2015,1,560,547,13,97.68,2.32
São José dos Campos,2015,2,157,157,0,100.0,0.0
São José dos Campos,2015,3,115,114,1,99.13,0.87
São José dos Campos,2015,4,740,726,14,98.11,1.89
São José dos Campos,2015,5,1957,1803,154,92.13,7.87
São José dos Campos,2015,6,2908,2301,607,79.13,20.87
São José dos Campos,2015,7,2764,2628,136,95.08,4.92
São José dos Campos,2015,8,2481,2380,101,95.93,4.07
São José dos Campos,2015,9,3334,2789,545,83.65,16.35
São José dos Campos,2015,10,3044,2963,81,97.34,2.66
São José dos Campos,2015,11,3028,2831,197,93.49,6.51
São José dos Campos,2015,12,3025,2529,496,83.6,16.4
São José dos Campos,2016,1,2947,2791,156,94.71,5.29
São José dos Campos,2016,2,2752,2613,139,94.95,5.05
São José dos Campos,2016,3,4123,3502,621,84.94,15.06
São José dos Campos,2016,4,3638,2813,825,77.32,22.68
São José dos Campos,2016,5,3221,2837,384,88.08,11.92
São José dos Campos,2016,6,3381,2981,400,88.17,11.83
São José dos Campos,2016,7,3767,2969,798,78.82,21.18
São José dos Campos,2016,8,4501,3760,741,83.54,16.46
São José dos Campos,2016,9,4541,3774,767,83.11,16.89
São José dos Campos,2016,10,4609,3541,1068,76.83,23.17
São José dos Campos,2016,11,2699,2208,491,81.81,18.19
São José dos Campos,2016,12,2746,2283,463,83.14,16.86
São José dos Campos,2017,1,5315,3569,1746,67.15,32.85
São José dos Campos,2017,2,2736,2468,268,90.2,9.8
São José dos Campos,2017,3,5141,3659,1482,71.17,28.83
São José dos Campos,2017,4,3708,2759,949,74.41,25.59
São José dos Campos,2017,5,4215,3542,673,84.03,15.97
São José dos Campos,2017,6,4366,4102,264,93.95,6.05
São José dos Campos,2017,7,6073,5031,1042,82.84,17.16
São José dos Campos,2017,8,5594,5027,567,89.86,10.14
São José dos Campos,2017,9,4846,3901,945,80.5,19.5
São José dos Campos,2017,10,4534,3973,561,87.63,12.37
São José dos Campos,2017,11,3982,3667,315,92.09,7.91
São José dos Campos,2017,12,3686,3262,424,88.5,11.5
São José dos Campos,2018,1,4143,3627,516,87.55,12.45
São José dos Campos,2018,2,3260,2595,665,79.6,20.4
São José dos Campos,2018,3,3405,3049,356,89.54,10.46
São José dos Campos,2018,4,3014,2599,415,86.23,13.77
São José dos Campos,2018,5,2625,2326,299,88.61,11.39
São José dos Campos,2018,6,2661,2375,286,89.25,10.75
São José dos Campos,2018,7,3026,2637,389,87.14,12.86
São José dos Campos,2018,8,2675,2388,287,89.27,10.73
São José dos Campos,2018,9,2524,2241,283,88.79,11.21
São José dos Campos,2018,10,3171,2755,416,86.88,13.12
São José dos Campos,2018,11,3227,2869,358,88.91,11.09
São José dos Campos,2018,12,2554,2123,431,83.12,16.88
São José dos Campos,2019,1,2960,2480,480,83.78,16.22
São José dos Campos,2019,2,2571,2187,384,85.06,14.94
São José dos Campos,2019,3,2417,2031,386,84.03,15.97
São José dos Campos,2019,4,2726,2434,292,89.29,10.71
São José dos Campos,2019,5,2362,2084,278,88.23,11.77
São José dos Campos,2019,6,2050,1780,270,86.83,13.17
São José dos Campos,2019,7,2460,2028,432,82.44,17.56
São José dos Campos,2019,8,2229,1993,236,89.41,10.59
São José dos Campos,2019,9,2042,1864,178,91.28,8.72
São José dos Campos,2019,10,2323,2046,277,88.08,11.92
São José dos Campos,2019,11,0,0,0,0.0,0.0
São José dos Campos,2019,12,0,0,0,0.0,0.0
Sorocaba,2015,1,893,881,12,98.66,1.34
Sorocaba,2015,2,261,260,1,99.62,0.38
Sorocaba,2015,3,177,176,1,99.44,0.56
Sorocaba,2015,4,1153,1138,15,98.7,1.3
Sorocaba,2015,5,1743,1516,227,86.98,13.02
Sorocaba,2015,6,2869,2029,840,70.72,29.28
Sorocaba,2015,7,2527,2289,238,90.58,9.42
Sorocaba,2015,8,2358,2199,159,93.26,6.74
Sorocaba,2015,9,3309,2553,756,77.15,22.85
Sorocaba,2015,10,2269,2174,95,95.81,4.19
Sorocaba,2015,11,2685,2391,294,89.05,10.95
Sorocaba,2015,12,3161,2519,642,79.69,20.31
Sorocaba,2016,1,2700,2383,317,88.26,11.74
Sorocaba,2016,2,2542,2296,246,90.32,9.68
Sorocaba,2016,3,3734,2811,923,75.28,24.72
Sorocaba,2016,4,3326,2230,1096,67.05,32.95
Sorocaba,2016,5,3292,2444,848,74.24,25.76
Sorocaba,2016,6,3296,2650,646,80.4,19.6
Sorocaba,2016,7,4537,2914,1623,64.23,35.77
Sorocaba,2016,8,4570,3343,1227,73.15,26.85
Sorocaba,2016,9,4642,3176,1466,68.42,31.58
Sorocaba,2016,10,4465,3260,1205,73.01,26.99
Sorocaba,2016,11,2319,1789,530,77.15,22.85
Sorocaba,2016,12,2538,2054,484,80.93,19.07
Sorocaba,2017,1,4839,2635,2204,54.45,45.55
Sorocaba,2017,2,2446,1996,450,81.6,18.4
Sorocaba,2017,3,4866,2895,1971,59.49,40.51
Sorocaba,2017,4,3624,2427,1197,66.97,33.03
Sorocaba,2017,5,4151,3179,972,76.58,23.42
Sorocaba,2017,6,3914,3463,451,88.48,11.52
Sorocaba,2017,7,4963,3401,1562,68.53,31.47
Sorocaba,2017,8,4331,3609,722,83.33,16.67
Sorocaba,2017,9,4067,3472,595,85.37,14.63
Sorocaba,2017,10,3952,3333,619,84.34,15.66
Sorocaba,2017,11,3494,3161,333,90.47,9.53
Sorocaba,2017,12,3403,2839,564,83.43,16.57
Sorocaba,2018,1,3622,3084,538,85.15,14.85
Sorocaba,2018,2,2933,2368,565,80.74,19.26
Sorocaba,2018,3,3319,2898,421,87.32,12.68
Sorocaba,2018,4,2986,2469,517,82.69,17.31
Sorocaba,2018,5,2578,2351,227,91.19,8.81
Sorocaba,2018,6,2429,2210,219,90.98,9.02
Sorocaba,2018,7,3045,2668,377,87.62,12.38
Sorocaba,2018,8,2886,2528,358,87.6,12.4
Sorocaba,2018,9,2771,2466,305,88.99,11.01
Sorocaba,2018,10,3347,2891,456,86.38,13.62
Sorocaba,2018,11,3059,2742,317,89.64,10.36
Sorocaba,2018,12,2708,2226,482,82.2,17.8
Sorocaba,2019,1,3032,2621,411,86.44,13.56
Sorocaba,2019,2,2754,2308,446,83.81,16.19
Sorocaba,2019,3,2488,1992,496,80.06,19.94
Sorocaba,2019,4,2553,2205,348,86.37,13.63
Sorocaba,2019,5,2471,2120,351,85.8,14.2
Sorocaba,2019,6,2071,1847,224,89.18,10.82
Sorocaba,2019,7,2362,1977,385,83.7,16.3
Sorocaba,2019,8,2054,1783,271,86.81,13.19
Sorocaba,2019,9,2426,2236,190,92.17,7.83
Sorocaba,2019,10,2431,2150,281,88.44,11.56
Sorocaba,2019,11,0,0,0,0.0,0.0
Sorocaba,2019,12,0,0,0,0.0,0.0
Vitoria,2015,1,17,17,0,100.0,0.0
Vitoria,2015,2,3,3,0,100.0,0.0
Vitoria,2015,3,1,1,0,100.0,0.0
Vitoria,2015,4,118,118,0,100.0,0.0
Vitoria,2015,5,1943,1943,0,100.0,0.0
Vitoria,2015,6,2730,2730,0,100.0,0.0
Vitoria,2015,7,3316,3316,0,100.0,0.0
Vitoria,2015,8,2578,2578,0,100.0,0.0
Vitoria,2015,9,2865,2865,0,100.0,0.0
Vitoria,2015,10,2985,2985,0,100.0,0.0
Vitoria,2015,11,3455,3455,0,100.0,0.0
Vitoria,2015,12,2927,2913,14,99.52,0.48
Vitoria,2016,1,3913,3654,259,93.38,6.62
Vitoria,2016,2,3323,3306,17,99.49,0.51
Vitoria,2016,3,4604,3958,646,85.97,14.03
Vitoria,2016,4,4815,3148,1667,65.38,34.62
Vitoria,2016,5,4139,3423,716,82.7,17.3
Vitoria,2016,6,3797,3250,547,85.59,14.41
Vitoria,2016,7,4515,3714,801,82.26,17.74
Vitoria,2016,8,5384,4798,586,89.12,10.88
Vitoria,2016,9,5234,4506,728,86.09,13.91
Vitoria,2016,10,5835,4247,1588,72.78,27.22
Vitoria,2016,11,3437,2720,717,79.14,20.86
Vitoria,2016,12,3685,3077,608,83.5,16.5
Vitoria,2017,1,6563,3787,2776,57.7,42.3
Vitoria,2017,2,3229,2598,631,80.46,19.54
Vitoria,2017,3,7020,4973,2047,70.84,29.16
Vitoria,2017,4,4682,3607,1075,77.04,22.96
Vitoria,2017,5,5410,4559,851,84.27,15.73
Vitoria,2017,6,6465,5406,1059,83.62,16.38
Vitoria,2017,7,6369,4978,1391,78.16,21.84
Vitoria,2017,8,8145,6116,2029,75.09,24.91
Vitoria,2017,9,5780,4684,1096,81.04,18.96
Vitoria,2017,10,5710,4844,866,84.83,15.17
Vitoria,2017,11,4920,4174,746,84.84,15.16
Vitoria,2017,12,4202,3716,486,88.43,11.57
Vitoria,2018,1,5062,4288,774,84.71,15.29
Vitoria,2018,2,5117,3251,1866,63.53,36.47
Vitoria,2018,3,4456,3650,806,81.91,18.09
Vitoria,2018,4,3854,3167,687,82.17,17.83
Vitoria,2018,5,3997,3294,703,82.41,17.59
Vitoria,2018,6,3060,2649,411,86.57,13.43
Vitoria,2018,7,3526,3008,518,85.31,14.69
Vitoria,2018,8,3320,3078,242,92.71,7.29
Vitoria,2018,9,3089,2774,315,89.8,10.2
Vitoria,2018,10,3670,3221,449,87.77,12.23
Vitoria,2018,11,3798,3378,420,88.94,11.06
Vitoria,2018,12,3232,2753,479,85.18,14.82
Vitoria,2019,1,3213,2820,393,87.77,12.23
Vitoria,2019,2,3207,2894,313,90.24,9.76
Vitoria,2019,3,2836,2414,422,85.12,14.88
Vitoria,2019,4,2722,2394,328,87.95,12.05
Vitoria,2019,5,2700,2369,331,87.74,12.26
Vitoria,2019,6,2402,2063,339,85.89,14.11
Vitoria,2019,7,2991,2436,555,81.44,18.56
Vitoria,2019,8,2588,2254,334,87.09,12.91
Vitoria,2019,9,2448,2181,267,89.09,10.91
Vitoria,2019,10,2784,2488,296,89.37,10.63
Vitoria,2019,11,0,0,0,0.0,0.0
Vitoria,2019,12,0,0,0,0.0,0.0